あ	逢	動詞ハ行四段	
あ	遇	動詞ハ行四段	偶然に遇ふ
あ	合	動詞ハ行四段	
あ	遭	動詞ハ行四段	災難に遭ふ
あ	亞	名詞	單漢字
あ	會	動詞ハ行四段	人に會ふ
あ	逅	動詞ハ行四段	
ああ	嗚呼	感動詞	
ああ	嗟呼	感動詞	
ああ	嗟嗟	感動詞	
ああ	噫呼	感動詞	
あい	愛	名詞サ変	
あいえつ	噫噎	名詞	
あいかう	愛好	名詞サ変	
あいきやう	愛敬	名詞	
あいぎやう	愛敬	名詞	
あいぐわん	哀願	名詞サ変	
あいくわん	哀歡	名詞サ変	
あいぐわん	愛玩	名詞サ変	
あいこん	鞋痕	名詞	
あいさつ	挨拶	名詞	
あいしう	哀愁	名詞	
あいしやう	哀傷	名詞サ変	
あいしやう	愛稱	名詞	
あいたう	哀悼	名詞サ変	
あいぢん	埃塵	名詞	
あいてい	鞋底	名詞	
あいど	埃土	名詞	
あいどく	愛讀	名詞サ変	
あいどくしよ	愛讀書	名詞	
あいめつ	埃滅	名詞	
あいるらんど	愛蘭	地名	
あいを	噫烏	名詞	
あう	央	名詞	呉音
あう	襖	名詞	單漢字
あう	櫻	名詞	漢音
あう	鶯	名詞	漢音
あういう	鶯友	名詞	
あうぎ	奧義	名詞	
あうくわ	櫻花	名詞	
あうし	襖子	名詞	
あうじゆ	櫻樹	名詞	
あうしゆくばい	鶯宿梅	名詞	
あうせ	逢瀬	名詞	
あうたう	櫻桃	名詞	
あうたう	鶯桃	名詞	
あえん	亞鉛	名詞	
あか	赫	形容詞	
あか	紅	形容詞	
あか	朱	形容詞	
あか	丹	形容詞	
あが	騰	動詞ラ行五段	
あか	銅	名詞	
あが	擧が	動詞ラ行五段	
あか	證	動詞サ行五段	
あかがね	銅	名詞	
あかし	燈	名詞	
あかし	證	名詞	
あかしびと	證人	名詞	
あかしぶみ	證文	名詞	
あかしんがう	赤信號	名詞	
あがた	縣	名詞	
あがたあるき	縣歩	名詞	
あがたみ	縣見	名詞	
あかつき	曉	名詞	
あかつきおき	曉起	名詞	
あがな	購	動詞ハ行四段	
あがな	贖	動詞ハ行四段	
あがなひもの	贖者	名詞	
あがなひもの	贖物	名詞	
あかはぢ	赤恥	名詞	
あき	厭	動詞一段	
あきな	商	動詞ハ行四段	
あきなひ	商	名詞	
あきもの	商物	名詞	
あく	渥	名詞	
あく	幄	名詞	單漢字
あくい	惡意	名詞	
あくおん	渥恩	名詞	
あくかんじやう	惡感情	名詞	
あくざ	幄座	名詞	
あくじ	惡事	名詞	
あくしや	幄舍	名詞	
あくしゆ	握手	名詞サ変	
あくぜん	渥然	名詞	
あくせん	惡戰	名詞サ変	
あくせん	惡錢	名詞	
あくせんくとう	惡戰苦鬭	名詞	
あくたく	渥澤	名詞	
あくにん	惡人	名詞	
あくばく	幄幕	名詞	
あくび	欠	名詞	
あくひつ	惡筆	名詞	
あくりよく	握力	名詞	
あけ	朱	名詞	
あげ	擧げ	動詞一段	
あげあし	擧げ足	名詞	
あげく	擧句	名詞	
あげつら	論	動詞ハ行四段	
あさ	淺	形容詞	
あさぎ	淺黄	名詞	
あさぎ	淺葱	名詞	
あささ	淺さ	名詞	
あさはか	淺はか	名詞形動	
あさまし	淺まし	形容詞	
あさましげ	淺ましげ	名詞形動	
あさましさ	淺ましさ	名詞	
あさみどり	淺緑	名詞	
あさみどりいろ	淺緑色	名詞	
あさめ	淺め	名詞	
あし	惡	名詞	
あじあ	亞細亞	地名	
あしゆら	阿修羅	人名	
あしら	遇	動詞ハ行四段	
あしら	配	動詞ハ行四段	
あぜ	校	名詞	
あせい	蛙聲	名詞	
あぜがや	畦茅	名詞	
あぜん	啞然	名詞	
あた	能	動詞ハ行四段	
あた	當	動詞ラ行五段	
あたかも	宛も	名詞	
あたたか	煖か	形容詞	
あたたか	煖か	名詞形動	
あたたか	溫か	形容詞	機種依存
あたたか	溫か	名詞形動	機種依存
あたたま	溫ま	動詞ラ行五段	機種依存
あたたま	溫め	動詞一段	機種依存
あたため	煖め	動詞一段	
あたひ	値	名詞	
あたひ	價	名詞	
あたへ	與へ	動詞一段	
あたら	可惜	名詞	
あたり	當	名詞	
あたり	邊	名詞	
あたりまへ	當前	名詞	
あぢ	味	名詞	
あぢけ	味氣	名詞	
あぢつけ	味付	名詞	
あぢは	味は	動詞ハ行四段	
あぢみ	味見	名詞サ変	
あつ	渥	形容詞	
あつ	壓	名詞サ変	慣用
あつか	扱	動詞ハ行四段	
あづか	預か	動詞ラ行五段	
あづか	與	動詞ラ行五段	
あづけ	預け	動詞一段	
あづま	東	名詞	
あづまをとこ	東男	名詞	
あづまをどり	東踊	名詞	
あつらへ	誂へ	動詞一段	
あて	當	名詞	
あな	孔	名詞	
あねつたい	亞熱帶	名詞	
あば	暴	動詞カ行五段	
あば	發	動詞カ行五段	
あはせ	袷	名詞	
あはせ	合せ	動詞一段	
あはせ	倂せ	動詞一段	
あはれ	哀	動詞マ行五段	
あはれ	哀	名詞	
あひ	間	名詞	
あひ	相	名詞	
あひうち	間打	名詞	
あひかぎ	合鍵	名詞	
あひかた	相方	名詞	
あひぎ	間着	名詞	
あひきやうげん	間狂言	名詞	
あひきやく	相客	名詞	
あびけうくわん	阿鼻叫喚	名詞サ変	
あひごま	合駒	名詞	
あひしやう	相性	名詞	
あひだ	間	名詞	
あひづ	合圖	名詞サ変	
あひづち	相槌	名詞	
あひて	相手	名詞	
あひびき	逢引	名詞サ変	
あひふく	間服	名詞	
あひふく	合服	名詞	
あひみたがひ	相身互	名詞	
あふ	凹	名詞	單漢字
あふ	押	名詞	漢音
あふ	鴨	名詞	漢音
あふ	仰	動詞ガ行五段	
あふ	扇	動詞ガ行五段	
あふ	煽	動詞ラ行五段	
あふ	壓	名詞	漢音
あぶ	焙	動詞ラ行五段	
あふいん	押印	名詞サ変	
あふいん	押韻	名詞	あふゐん
あふぎ	扇	名詞	
あふしう	押收	名詞サ変	
あふとつ	凹凸	名詞	
あふなつ	押捺	名詞サ変	
あふばん	凹板	名詞	
あふむ	仰向	動詞カ行五段	
あふめんきやう	凹面鏡	名詞	
あぶらえ	油繪	名詞	あぶらゑ
あぶらゑ	油繪	名詞	
あふりやう	押領	名詞サ変	
あぶれ	溢れ	動詞一段	
あふれんず	凹レンズ	名詞	
あふゐん	押韻	名詞	
あへ	敢	動詞一段	
あへ	和へ	動詞一段	
あへ	喘	動詞ガ行五段	
あへて	敢て	名詞	
あへもの	和物	名詞	
あま	亞麻	名詞	
あま	餘	動詞ラ行五段	
あみだ	阿彌陀	人名	
あやし	恠	形容詞	
あやふ	危ふ	形容詞	
あやふい	危い	形容詞	
あらがね	鑛	名詞	
あらそ	爭	動詞ハ行四段	
あらたま	荒魂	組織	
あらたま	荒魂之會	組織	
あらたまのくわい	荒魂之會	組織	
あらは	著	動詞サ行五段	
あらはれ	現れ	動詞一段	
あらはれ	表れ	動詞一段	
あらはれ	露れ	動詞一段	
あらはれ	顯れ	動詞一段	
ありう	亞流	名詞	
ありうさん	亞硫酸	名詞	
ある	步	動詞カ行五段	機種依存文字
あれい	啞鈴	名詞	啞（唖）鈴>>亜鈴
あを	蒼	形容詞	
あを	靑	名詞	機種依存
あをい	靑い	形容詞	機種依存
あをいき	靑息	名詞	機種依存
あをいきといき	靑息吐息	名詞	機種依存
あをくさ	靑臭	形容詞	機種依存
あをじやしん	靑寫眞	名詞	機種依存
あをじろ	靑白	形容詞	機種依存
あをしんがう	靑信號	名詞	機種依存
あをすぢ	靑筋	名詞	機種依存
あをな	靑菜	名詞	
あをなみ	蒼波	名詞	
あをみ	靑み	名詞	
あをみ	靑味	名詞	
あをもの	靑物	名詞	機種依存
あん	闇	名詞	
あんしやう	暗誦	名詞サ変	暗誦>>暗唱
あんばい	鹽梅	名詞形動	
あんや	闇夜	名詞	闇夜>>暗夜
あんらく	安樂	名詞形動	
あんをん	安隱	名詞形動	
い	ゐ	動詞一段	
い	謂	動詞ハ行四段	
い	云	動詞ハ行四段	
い	言	動詞ハ行四段	
い	寐	動詞ナ行五段	
い	鑄	動詞一段	
いあつ	威壓	名詞	ゐあつ
いいう	畏友	名詞	ゐいう
いいらくらく	易々樂々	名詞	
いいん	醫院	名詞	いゐん
いう	鮪	名詞	漢音
いう	優	名詞	
いう	有	名詞	
いうあく	優渥	名詞	
いうい	有爲	名詞	いうゐ
いううつ	憂鬱	名詞形動	
いうかう	有效	名詞形動	
いうぎ	遊戱	名詞	
いうくわく	遊廓	名詞	
いうしゆん	優駿	名詞	優駿>>優俊（新）
いうびん	郵便	名詞	
いうゐ	有爲	名詞	
いえ	ヰヱ	名詞	假名入力用
いえ	ゐゑ	名詞	假名入力用
いかう	意嚮	名詞	意嚮>>意向
いがく	醫學	名詞	
いかけ	鑄掛	名詞	
いがた	鑄型	名詞	
いかづち	雷	名詞	
いかめし	嚴	形容詞	
いき	噫氣	名詞	
いきさつ	經緯	名詞	
いきどほ	憤	動詞ラ行五段	
いきほひ	勢ひ	名詞	
いきよく	委曲	名詞	ゐきよく
いくさ	軍	名詞	
いくさ	戰	名詞	
いくぢゆう	幾重	名詞	
いくへ	幾重	名詞	
いぐわい	以外	名詞形動	
いくわくちやう	胃擴張	名詞	ゐくわくちやう
いくわん	偉觀	名詞形動	ゐくわん
いくわん	尉官	名詞	ゐくわん
いくわんそく	維管束	名詞	ゐくわんそく
いげふ	偉業	名詞	ゐげふ
いげん	威嚴	名詞	ゐげん
いご	圍碁	名詞	ゐご
いざな	誘	動詞ハ行四段	
いさを	功	名詞	
いじ	遺兒	名詞	ゐじ
いし	醫師	名詞	
いじたい	異字體	名詞	
いしだたみ	石疊	名詞	
いしや	葦車	名詞	ゐしや
いしや	慰籍	名詞サ変	ゐしや
いしや	醫者	名詞	
いじやう	以上	名詞	
いじやう	異常	名詞	
いしやう	衣裳	名詞	衣裳>>衣装
いじやく	胃弱	名詞	ゐじやく
いしやれう	慰藉料	名詞	慰藉料>>慰謝料、ゐしやれう
いしゆく	萎縮	名詞サ変	萎縮>>委縮
いしよ	遺書	名詞	ゐしよ
いしよく	委嘱	名詞	ゐしよく
いせい	爲政	名詞	ゐせい
いせいしや	爲政者	名詞	ゐせいしや
いせき	葦席	名詞	ゐせき
いた	ゐた	名詞	
いだ	懷	動詞カ行五段	機種依存
いたづら	徒	副詞	
いたづら	徒	名詞形動	
いたは	勞	動詞ラ行五段	
いちえん	一圓	副詞	
いちでふ	一帖	名詞	
いぢめ	苛め	動詞一段	
いぢめ	虐め	動詞一段	
いちやう	胃腸	名詞	ゐちやう
いちやう	鴨脚	名詞	月＋卻
いぢやうふ	偉丈夫	名詞	ゐぢやうふ
いちらん	一覽	名詞サ変	
いつかくせんきん	一攫千金	名詞	一攫千金>>一獲千金
いつかつ	一喝	名詞サ変	機種依存
いつくわつ	一括	名詞サ変	
いづくんぞ	安	名詞	
いづくんぞ	焉	名詞	
いつけつ	溢血	名詞	
いつすい	溢水	名詞	
いつは	詐	動詞ラ行五段	
いつは	僞	動詞ラ行五段	
いづれ	何	名詞	
いづれ	孰	名詞	
いでん	遺傳	名詞サ変	ゐでん
いと	意圖	名詞サ変	
いと	厭	動詞ハ行四段	
いとな	營	動詞マ行五段	
いとほし	愛	形容詞	
いな	稻	名詞	
いなさく	稻作	名詞サ変	
いなづま	電	名詞	
いなほ	稻穂	名詞	
いなむら	稻叢	名詞	
いなむらがさき	稻村ヶ﨑	地名	
いなり	稻貨	名詞	
いにしへ	古	名詞	
いぬゐ	戌亥	名詞	
いは	岩	名詞	
いは	祝	動詞ハ行四段	
いは	磐	名詞	
いは	巖	名詞	
いはう	違法	名詞形動	ゐはう
いはな	岩魚	名詞	
いはほ	巖	名詞	
いはゆる	所謂	名詞	
いはんや	況や	名詞	
いひ	飯	名詞	
いひだこ	飯章魚	名詞	
いひだこ	飯蛸	名詞	
いびやう	胃病	名詞	ゐびやう
いへ	家	名詞	
いへども	雖も	名詞	
いほり	庵	名詞	
いま	座	動詞サ行五段	
いま	在	動詞サ行五段	
います	ゐます	名詞	
いまはし	忌	形容詞	
いもの	鑄物	名詞	
いや	醫	動詞サ行五段	
いやく	醫藥	名詞	
いやし	賤	動詞マ行五段	
いらう	慰勞	抑制単語	ゐらう
いりよく	威力	名詞	ゐりよく
いる	ゐる	名詞	
いれい	慰靈	名詞	ゐれい
いれいさい	慰靈祭	名詞	ゐれいさい
いれう	醫療	名詞	
いろり	圍爐裏	名詞	ゐろり
いわう	以往	名詞	
いゐき	異域	名詞	
いゐん	醫院	名詞	
いんえい	陰翳	名詞	陰翳>>陰影
いんえん	因緣	名詞	發音はインネン
いんがう	院號	名詞	ゐんがう
いんきよ	隱居	名詞	
いんぐわ	因果	名詞	
いんくわ	隱花	名詞	
いんぐわおうほう	因果應報	名詞	
いんくわしよくぶつ	隱花植物	名詞	
いんご	隱語	名詞	
いんじや	隱者	名詞	
いんしゆ	飮酒	名詞サ変	
いんしよく	飮食	名詞サ変	
いんぜん	隱然	名詞	
いんてつ	隕鐵	名詞	ゐんてつ
いんとく	隱匿	名詞サ変	
いんとくぶつ	隱匿物	名詞	
いんび	婬靡	名詞形動	
いんぷ	婬婦	名詞	
いんぺい	隱蔽	名詞サ変	
いんぼう	隱謀	名詞	
いんめつ	湮滅	名詞サ変	湮滅>>隠滅
いんようすい	飮用水	名詞	
いんらん	婬亂	名詞形動	
いんれう	飮料	名詞	
いんれうすい	飮料水	名詞	
う	鮪	名詞	呉音
う	嗚	名詞	呉音
う	毆	名詞	呉音
う	謳	名詞	呉音
う	賣	動詞ラ行五段	
う	鷗	名詞	漢音、機種依存
うい	外	名詞	唐音
うい	有爲	名詞	うゐ
ういう	烏有	名詞形動	
ういすきー	ウヰスキー	名詞	
ういてんぺん	有爲轉變	名詞	うゐてんぺん
ういらう	外郎	名詞	
うえ	植ゑ	動詞一段	
うえ	植ゑ	名詞	
うかが	窺	動詞ハ行四段	
うがひ	鵜飼	名詞	
うがふ	烏合	名詞	
うぐひす	鶯	名詞	
うぐひすいろ	鶯色	名詞	
うぐひすだに	鶯谷	地名	
うぐひすちや	鶯茶	名詞	
うぐひすぢやう	鶯孃	名詞	
うぐひすばり	鶯張	名詞	
うぐひすもち	鶯餅	名詞	
うくわい	迂囘	名詞サ変	
うけお	請負	動詞ハ行四段	
うけおひげふ	請負業	名詞	
うけたまは	承	動詞ラ行五段	
うしな	失	動詞ハ行四段	
うしほ	潮	名詞	
うしほじる	潮汁	名詞	
うしほに	潮煮	名詞	
うた	唄	動詞ハ行四段	
うた	歌	動詞ハ行四段	
うた	謠	動詞ハ行四段	
うた	謳	動詞ハ行四段	
うたが	疑	動詞ハ行四段	
うたがく	歌學	名詞	方便
うたくわい	歌會	名詞	
うたくわいはじめ	歌會始	名詞	
うたた	轉	名詞	
うたたごころ	轉心	名詞	
うたたね	轉寢	名詞	
うたひこう	謠講	名詞	
うたひぞめ	謠初	名詞	
うたひもの	謠物	名詞	
うぢ	氏	名詞	
うちう	宇宙	名詞	
うぢがみ	氏神	名詞	
うぢこ	氏子	名詞	
うぢすじやう	氏素性	名詞	
うぢでら	氏寺	名詞	
うちわけ	内訣	名詞	
うづ	渦	名詞	
うづ	埋	動詞マ行五段	
うつ	寫	動詞サ行五段	
うつ	寫	動詞ラ行五段	
うづ	疼	動詞カ行五段	
うつくしい	美い	形容詞	
うつけつ	鬱血	名詞	
うつさう	鬱蒼	名詞形動	
うづしほ	渦潮	名詞	
うつせき	鬱積	名詞	
うづたか	堆	形容詞	
うつたへ	訴へ	動詞一段	
うつは	器	名詞	
うつぷん	鬱憤	名詞	
うづま	渦卷	動詞カ行五段	
うてな	臺	名詞	
うなづ	肯	動詞カ行五段	
うば	奪	動詞ハ行四段	
うはがき	上書	名詞	
うはぎ	上着	名詞	
うはさ	噂	名詞	
うはず	上擦	動詞ラ行五段	
うはすべり	上滑	名詞	
うはずみ	上澄	名詞	
うはぜ	上背	名詞	
うはつぱり	上つ張り	名詞	
うはづみ	上積	名詞	
うはつら	上面	名詞	
うはて	上手	名詞	
うはてうし	上調子	名詞	
うはぬり	上塗	名詞	
うはのそら	上の空	名詞	
うはばき	上履	名詞	
うはべ	上邊	名詞	
うはまは	上囘	動詞ラ行五段	
うはまへ	上前	名詞	
うはむき	上向	名詞	
うはめ	上目	名詞	
うはめづかひ	上目遣	名詞	
うはやく	上役	名詞	
うへ	上	名詞	
うべな	諾	動詞ハ行四段	
うまや	驛	名詞	
うみべ	海邊	名詞	
うやま	敬	動詞ハ行四段	
うよきよくせつ	紆余曲折	名詞	
うらな	占	動詞ハ行四段	
うるは	潤	動詞ハ行四段	
うるはし	麗	形容詞	
うるふ	閏	名詞	
うるほ	渥	動詞ハ行四段	
うれへ	愁へ	動詞一段	
うれへ	憂へ	動詞一段	
うわうさわう	右往左往	名詞サ変	
うゐ	有爲	名詞	
うゐてんぺん	有爲轉變	名詞	
うゑ	餓ゑ	動詞一段	
うを	魚	名詞	
うをいちば	魚市場	名詞	
うをがし	魚河岸	名詞	
うをのめ	魚の目	名詞	
うんい	云爲	名詞	
うんえい	運營	名詞サ変	
うんさんむせう	雲散霧消	名詞	
うんてん	運轉	名詞サ変	
え	壊	名詞	呉音、ゑ
え	懐	名詞	ゑ、呉音
え	酔	動詞ハ行四段	ゑふ
え	壞	名詞	呉音、ゑ、機種依存
え	懷	名詞	ゑ、呉音、機種依存
え	繪	名詞	呉音、ゑ
えいい	營爲	名詞	えいゐ
えいえい	營々	名詞形動	
えいが	榮華	名詞	
えいきう	永久	名詞	
えいきがう	嬰記號	名詞	
えいぐわ	映畫	名詞	
えいぐわ	榮華	名詞	
えいくわう	榮光	名詞	
えいげふ	營業	名詞サ変	
えいこせいすい	榮枯盛衰	名詞	
えいごふ	永劫	名詞	
えいごふくわいき	永劫囘歸	名詞	
えいさい	穎才	名詞	穎才>>英才
えいじ	嬰兒	名詞	
えいしん	榮進	名詞サ変	
えいせい	衞星	名詞	
えいせい	衞生	名詞	
えいせいとし	衞星都市	名詞	
えいち	叡智	名詞	叡智>>英知
えいやう	營養	名詞	
えいよ	榮譽	名詞	
えいり	營利	名詞	
えいゐ	營爲	名詞	
えう	要	名詞サ変	單漢字
えうきう	要求	名詞サ変	
えうくわい	妖怪	名詞	
えうくわいへんげ	妖怪變化	名詞	
えうくわいへんげ	妖恠變化	名詞	
えうねん	幼年	名詞	
えうらしあ	歐羅細亞	地名	
えうりやう	要領	名詞	
えうろぱ	歐羅巴	地名	
えかう	廻向	名詞	ゑかう
えきちやう	驛長	名詞	
えきでん	驛傳	名詞	
えきとう	驛頭	名詞	
えじ	衞士	名詞	
えじぷと	埃及	地名	
えそ	壊疽	名詞	ゑそ
えそ	壞疽	名詞	機種依存
えそらごと	繪空言	名詞	ゑそらごと
えづ	繪圖	名詞	ゑづ
えとき	繪解	名詞	ゑとき
えにし	緣	名詞	
えふ	押	名詞	呉音
えふ	鴨	名詞	呉音
えふ	壓	名詞	呉音
えほん	繪本	名詞	ゑほん
えら	擇	動詞バ行五段	
えんがい	鹽害	名詞	
えんかつ	圓滑	名詞形動	
えんがは	緣側	名詞	
えんぎ	緣起	名詞	
えんぐみ	緣組	名詞	
えんくわ	鹽化	名詞サ変	
えんご	掩護	名詞サ変	敵の攻撃から、味方の行動を守ること。
えんご	援護	名詞サ変	困っている人を助け守ること。
えんこ	緣故	名詞	
えんざう	鹽藏	名詞サ変	
えんしう	圓周	名詞	
えんしふ	演習	名詞サ変	
えんたく	圓卓	名詞	
えんにち	緣日	名詞	
えんねつ	圓熱	名詞	
えんぶん	鹽分	名詞	
えんまん	圓滿	名詞形動	
えんむすび	緣結	名詞	
えんゆ	緣由	名詞	
えんるい	鹽類	名詞	
お	生	動詞ハ行四段	
お	逐	動詞ハ行四段	
お	追	動詞ハ行四段	
お	負	動詞ハ行四段	
お	負	動詞ハ行四段	
おう	毆	名詞	漢音
おう	鷗	名詞	漢音、機種依存
おうえい	謳詠	名詞サ変	
おうえん	應援	名詞サ変	
おうぐわい	鷗外	名詞	機種依存
おうさつ	毆殺	名詞サ変	
おうさつ	毆殺	名詞サ変	機種依存
おうしう	鷗州	名詞	機種依存
おうしやう	謳唱	名詞サ変	
おうだ	毆打	名詞サ変	
おうたい	應對	名詞サ変	
おうたう	應當	名詞サ変	
おうたふ	應答	名詞サ変	
おうてう	鷗鳥	名詞	機種依存
おうべい	歐米	名詞	
おうやう	鷹揚	名詞形動	
おうよう	應用	名詞サ変	
おうりやう	謳領	名詞サ変	
おかめ	阿龜	名詞	
おき	隱岐	地名	
おぎな	補	動詞ハ行四段	
おく	奧	名詞	
おく	贈	動詞ラ行五段	
おくがき	奧書	名詞	
おくぎ	奧義	名詞	
おくくう	億劫	名詞形動	
おくせつ	臆説	名詞	
おくそく	臆測	名詞	
おくだん	臆斷	名詞サ変	臆斷>>憶断
おくに	阿國	人名	
おくびやう	臆病	名詞形動	臆病>>憶病
おくぶか	奧深	形容詞	
おくまん	億萬	名詞	
おくゆかし	奧ゆかし	形容詞	
おくゆき	奧行	名詞	
おくりおほかみ	送狼	名詞	
おくれ	遲れ	動詞一段	
おごそか	嚴	名詞形動	
おこな	行	動詞ハ行四段	
おさへ	押へ	動詞一段	
おさへ	抑へ	動詞一段	
おし	啞	名詞	
おそ	襲	動詞ハ行四段	
おそれ	虞れ	動詞一段	
おそれ	惧れ	動詞一段	心＋瞿
おだやか	隱	名詞形動	
おつしや	仰	動詞ラ行五段	
おつしや	仰有	動詞ラ行五段	
おとな	訪な	動詞ハ行四段	
おとろへ	衰へ	動詞一段	
おのづから	自ら	名詞	
おは	在	動詞サ行五段	
おび	帶	名詞	
おび	帶び	動詞一段	
おびかは	帶皮	名詞	
おびじめ	帶締	名詞	
おびどめ	帶止	名詞	
おびふう	帶封	名詞	
おほ	多	形容詞	
おほ	大	形容詞	
おほ	被	動詞ハ行四段	
おほ	覆	動詞ハ行四段	
おほあぢ	大味	名詞	
おほいり	大入	名詞サ変	
おぼえ	覺え	動詞一段	
おほおみ	大臣	名詞	
おほがた	大型	名詞	
おほかた	大方	名詞	
おほかみ	狼	名詞	
おほかみせうねん	狼少年	名詞	
おほがら	大柄	名詞	
おほき	大き	形容詞	
おほぎやう	大仰	名詞形動	
おほぎやう	大形	名詞形動	
おほげさ	大袈裟	名詞形動	
おほげふ	大業	名詞形動	
おほざつぱ	大雜把	名詞形動	
おほすぢ	大筋	名詞	
おほせ	果せ	動詞一段	
おほせ	仰	名詞	
おほぜい	大勢	名詞	
おほせつけ	仰付け	動詞一段	
おほづめ	大詰	名詞	
おほて	大手	名詞	
おほどほり	大通	名詞	
おほとり	鳳	名詞	
おほはば	大幅	名詞形動	
おほばんぶるまひ	大盤振舞	名詞	
おほぶろしき	大風呂敷	名詞	
おほみづ	大水	名詞	
おほむね	概	名詞	
おほむね	槪	名詞	機種依存
おほや	大家	名詞	
おほやけ	公	名詞形動	
おぼろげ	朧氣	名詞形動	
おもかぢ	面舵	名詞	
おん	隱	名詞	
おんがく	音樂	名詞	
おんぎ	恩誼	名詞	恩誼>>恩義
おんみつ	隱密	名詞形動	
おんゐき	音域	名詞	
おんゐん	音韻	名詞	
か	交	動詞ハ行四段	
か	支	動詞ハ行四段	
か	飼	動詞ハ行四段	
か	買	動詞ハ行四段	
か	假	名詞サ変	漢音
かい	亥	名詞	漢音
かい	蟹	名詞	
かい	劾	名詞	漢音
がい	外	名詞	漢音
かい	咳	名詞	漢音
がいえう	概要	名詞	
がいえう	槪要	名詞	機種依存
かいかう	蟹行	名詞サ変	
かいかふ	蟹甲	名詞	
かいきふ	階級	名詞	
かいくわ	開花	名詞サ変	
がいくわ	凱歌	名詞サ変	
かいぐわい	海外	名詞	
がいくわく	外廓	名詞	
かいけふ	海峽	名詞	
かいげふ	開業	名詞サ変	
かいげふい	開業醫	名詞	
がいしう	劾秋	名詞	
かいしやく	解釋	名詞サ変	
がいだん	劾彈	名詞	
かいはう	解放	名詞サ変	
かう	學	名詞	をしへる、漢音
かう	效	名詞	
がう	號	名詞	
かう	黃	名詞	
かうい	校醫	名詞	
かうい	行爲	名詞	かうゐ
がういん	强引	名詞形動	
かううんき	耕耘機	名詞	
かうか	高價	名詞形動	
かうかつ	硬骨	名詞	{魚更}骨>>硬骨（國）
かうぎ	講義	名詞	
かうくわ	硬貨	名詞	
かうくわ	效果	名詞	
かうくわい	狡獪	名詞形動	
かうくわてき	效果的	名詞形動	
かうくわん	交驩	名詞サ変	交驩>>交歓（國）
かうげ	香華	名詞	
がうけつ	豪傑	名詞	
かうこがく	考古學	名詞	
かうこつ	{魚更}骨	名詞	{魚更}骨>>硬骨（國）
かうこつ	硬骨	名詞	{魚更}骨>>硬骨（國）
かうさ	交叉	名詞サ変	交叉>>交差（國）
かうさてん	交叉點	名詞	
かうしよう	考證	名詞サ変	
かうしん	昂進	名詞サ変	昂（亢）進>>高進（新）
かうしん	亢進	名詞サ変	昂（亢）進>>高進（新）
かうせい	較正	名詞サ変	
かうせい	校正	名詞サ変	
かうせい	甦生	名詞サ変	甦生>>更正（國）
かうせふ	交涉	名詞サ変	
かうつう	交通	名詞サ変	
かうつうくわ	交通禍	名詞	
かうてい	校訂	名詞サ変	
かうでん	香奠	名詞	香奠>>香典（國）
かうとう	昂騰	名詞サ変	昂騰>>高騰（國）
かうふん	昂奮	名詞サ変	昂(亢)奮>>興奮（國）
かうふん	亢奮	名詞サ変	昂(亢)奮>>興奮（國）
かうや	曠野	名詞	曠野>>広野
かうやう	昂揚	名詞サ変	昂揚>>高揚（國）
かうよう	效用	名詞	
がうよく	强慾	名詞形動	强慾>>強欲（國）
かうりつ	效率	名詞	
かうわ	媾和	名詞サ変	媾和>>講和（國）
かうゐ	行爲	名詞	
かうを	好惡	名詞	
かえう	歌謠	名詞	
かえん	火焰	名詞	火焰（焔）>>火炎
かかう	下降	名詞サ変	
かがく	歌學	名詞	
かかく	價格	名詞	
かかは	拘	動詞ラ行五段	
かかは	關は	動詞ラ行五段	
かかへ	抱へ	動詞一段	
かがよ	耀	動詞ハ行四段	
かきこ	書込	動詞マ行五段	
かきこみ	書込	名詞	
かぎよ	歌語	名詞	
かく	假	名詞	漢音、いたる（至）の謂
かく	學	名詞	まなぶ、漢音
がくいん	學院	名詞	がくゐん
がくえん	學園	名詞	がくゑん
かくおび	角帶	名詞	
がくかい	學界	名詞	
かくかう	恰好	名詞	恰好>>格好（新）
がくき	樂器	名詞	
がくきよく	樂曲	名詞	
かくくわさうやう	隔靴掻痒	名詞	
かくご	覺悟	名詞サ変	
がくしき	學識	名詞	
かくじつ	確實	名詞形動	
がくしふ	學習	名詞サ変	
がくしや	學者	名詞	
がくしや	學舍	名詞	
がくせい	學生	名詞	
かくせい	覺醒	名詞サ変	
かくせいざい	覺醒劑	名詞	
がくたい	樂隊	名詞	
がくだん	樂團	名詞	
かくち	覺知	名詞サ変	
がくぢやう	嶽丈	名詞	
かくとう	挌闘	名詞	挌闘>>格闘
がくふ	嶽父	名詞	
がくふ	樂譜	名詞	
かくま	匿	動詞ハ行四段	
がくもん	學問	名詞サ変	
かぐら	神樂	名詞	
かぐら	神樂	名詞	機種依存
がくりよく	學力	名詞	
がくりよくけんてい	學力檢定	名詞サ変	
かくれ	隱れ	動詞一段	
かくれが	隱家	名詞	
がくろく	嶽麓	名詞	
かくわう	霞光	名詞	
がくゑん	學園	名詞	
がくをう	嶽翁	名詞	
かけ	缺け	動詞一段	
かけ	驅け	動詞一段	
かけぢく	掛軸	名詞	
かげふ	稼業	名詞	
かげろう	蜉蝣	名詞	
かげろう	蜻蛉	名詞	
かこ	圍	動詞ハ行四段	
かこ	圍	動詞マ行五段	
かさう	假裝	名詞サ変	
かし	假死	名詞サ変	
かしづ	侍	動詞カ行五段	
かしづ	傅	動詞カ行五段	
かしは	柏	名詞	
かしふ	歌集	名詞	
かしやく	假借	名詞サ変	
かず	數	名詞	
かせつ	假設	名詞サ変	
かぞへ	數へ	動詞一段	
かたがた	旁	名詞	
かたはら	側	名詞	
かたはら	傍	名詞	
かぢ	梶	名詞	
かち	割	名詞	呉音
かち	葛	名詞	呉音
かぢ	舵	名詞	
かち	價値	名詞	
かぢ	楫	名詞	
かち	喝	名詞	呉音、機種依存
かち	渴	名詞	かわく、呉音、機種依存
かぢとり	楫取	名詞	
かぢぼう	梶棒	名詞	
かぢゆう	荷重	名詞	
かつあい	渴愛	名詞サ変	機種依存
かつかう	恰好	名詞形動	恰好>>格好（新）
かつがう	渴仰	名詞サ変	機種依存
かつぎやう	渴仰	名詞サ変	機種依存
かつきよ	割據	名詞サ変	
かつさい	喝采	名詞サ変	機種依存
かつすい	渴水	名詞サ変	機種依存
かつすいき	渴水期	名詞	機種依存
かつとう	葛藤	名詞サ変	
かつぱ	喝破	名詞サ変	機種依存
かつぱう	割烹	名詞	
かつばう	渴望	名詞サ変	機種依存
かつぱつ	活潑	名詞形動	活潑（溌）>>活発
かつぷく	割腹	名詞サ変	
かつぷく	恰幅	名詞	恰幅>>格幅（新）
かづら	葛	名詞	
かつろう	葛籠	名詞	
かつゑ	餓ゑ	動詞一段	
かてい	假定	名詞サ変	
かでう	箇条	名詞	
かでうがき	箇條書	名詞	箇條書き>>個条書き
かどはか	拐	動詞サ行五段	
かな	假名	名詞	
かなづかひ	假名遣	名詞	
かにふ	加入	名詞サ変	
かは	革	名詞	
かは	川	名詞	
がは	側	名詞	
かは	皮	名詞	
かはい	可愛	形容詞	
かはいさう	可哀相	名詞形動	
かはせ	爲替	名詞	
かはら	河原	名詞	
かはら	瓦	名詞	
かはら	川原	名詞	
かひ	貝	名詞	
かひこ	蠶	名詞	
かひざいく	貝細工	名詞	
かひばしら	貝柱	名詞	
かふ	押	名詞	漢音
がふ	業	名詞	
かふおつ	甲乙	名詞	
かふおつへいてい	甲乙丙丁	名詞	
がふどう	合同	名詞	
がふべん	合辦	名詞サ変	合辦（辛二つの間に力）>>合弁
がふり	合理	名詞	
がふりてき	合理的	名詞形動	
かへ	換へ	動詞一段	
かへ	還	動詞一段	
かへ	更へ	動詞一段	
かへ	替へ	動詞一段	
かへ	代へ	動詞一段	
かへ	反	動詞一段	
かへ	返	動詞サ行五段	
かへ	返	動詞ラ行五段	
かへ	返	動詞一段	
かへ	孵	動詞一段	
かへ	變へ	動詞一段	
かへ	歸	動詞ラ行五段	
かへつて	卻つて	副詞	卻>>却
かへで	楓	名詞	
かへりち	返値	名詞	
かへりみ	顧み	動詞一段	
かへりみ	省み	動詞一段	
かへる	蛙	名詞	
がへん	肯ん	動詞ザ変	
かほ	顔	名詞	
かぼちや	南瓜	名詞	
かま	構	動詞ハ行四段	
かみのく	上句	名詞	
かみやしろ	神社	名詞	
かめん	假面	名詞	
かもつえき	貨物驛	名詞	
かり	假	名詞形動	
かりう	下流	名詞	
かを	薫	動詞ラ行五段	
かを	香	動詞ラ行五段	
かを	薰	動詞ラ行五段	機種依存
かをく	家屋	名詞	
かをり	香り	名詞	
かんおう	感應	名詞サ変	
かんがい	旱害	名詞	旱害>>干害（國）
かんかく	感覺	名詞	
かんくわ	干戈	名詞	
かんくわ	感化	名詞サ変	
かんけつ	間歇	名詞	間歇>>間欠（國）
かんじやう	感情	名詞	
かんしよく	間食	名詞サ変	
かんじん	肝腎	名詞形動	肝腎>>肝心（國）
かんじんかなめ	肝腎要	名詞	
かんすう	函數	名詞	函数>>関数
かんたん	簡單	名詞形動	
かんてん	旱天	名詞	旱天>>干天（國）
かんどり	楫取	名詞	
かんばつ	旱魃	名詞	
かんりう	乾溜	名詞	乾溜>>乾留（國）
き	傀	名詞	單漢字
き	黃	名詞	
きいん	氣韻	名詞	きゐん
きう	舊	名詞	
きうか	休暇	名詞	
きうか	舊家	名詞	
きうせき	舊蹟	名詞	舊蹟>>旧跡（國）
ぎうにゆう	牛乳	名詞	
きうめい	糺明	名詞サ変	糺明>>糾明（國）
きうやう	休養	名詞サ変	
きうりよう	丘陵	名詞	
きえん	気焔	名詞	気焔>>気炎（國）
ぎえん	義捐	名詞	義捐>>義援
ぎえんきん	義捐金	名詞	義捐金>>義援金（新）
きがう	記號	名詞	
きかつ	飢渴	名詞サ変	機種依存
きき	嬉々	名詞	嬉々>>喜々
ききくわいくわい	奇々怪々	名詞	
きくわ	奇禍	名詞	
きぐわ	起臥	名詞サ変	
きくわい	奇怪	名詞形動	
きくわく	企劃	名詞サ変	
きくわん	稀覯	名詞	
きけい	畸形	名詞	畸形>>奇形（國）
きげふ	企業	名詞サ変	
きげふ	起業	名詞サ変	
きげんそ	稀元素	名詞	稀元素>>希元素（國）
きし	軋	動詞ラ行五段	
きしつ	氣質	名詞	
きしやう	徽章	名詞	身分・資格・所屬團體などを表すために、衣服・帽子などにつけるしるしのこと。
きしやう	記章	名詞	記念として參加者・關係者に與へるしるしのこと。
きしやく	稀釋	名詞サ変	稀釈>>希釈（國）
きしゆ	機種	名詞	
きじゆつ	記述	名詞サ変	
きじん	畸人	名詞	畸人>>奇人
きせう	稀少	名詞形動	稀少>>希少（國）
きそん	毀損	名詞サ変	毀損>>棄損
きたい	稀代	名詞	稀代>>希代（國）
きだん	綺談	名詞	巧みに作られた、面白い話のこと。
きち	機智	名詞	機智>>機知（國）
きつきよう	吉凶	名詞	
きつすい	吃水	名詞	吃水>>喫水（國）
きなふ	歸納	名詞サ変	
きなふてき	歸納的	名詞	
きなふはふ	歸納法	名詞	
きのふ	昨日	名詞	
きは	劾	動詞マ行五段	
きばう	希望	名詞	
きはく	稀薄	名詞形動	稀薄>>希薄（國）
きはく	氣魄	名詞	気魄>>気迫（新）
きはめ	劾め	動詞一段	
きふだい	及第	名詞サ変	
きふむ	急務	名詞	
きふよ	給與	名詞	
きべん	詭辯	名詞	詭弁>>奇弁・危弁（新）
ぎやう	行	名詞	
きやう	經	名詞	
きやうえん	饗宴	名詞	饗宴>>供宴（新）
きやうげん	狂言	名詞	
きやうこ	鞏固	名詞	鞏固>>強固（國）
きやうさう	競爭	名詞サ変	
きやうだい	鏡臺	名詞	
きやうだい	兄弟	名詞	
ぎやうてん	仰天	名詞サ変	
きやうとうほ	橋頭堡	名詞	橋頭堡>>橋頭保（新）
きやうぶん	經文	名詞	
きやうわう	饗應	名詞サ変	饗応>>供応（國）
きやうをんな	京女	名詞	
きやく	假	名詞	呉音、いたる（至）の謂
きやく	攫	名詞	漢音
きやく	矍	名詞	漢音
きやくいん	脚韻	名詞	きやくゐん
きやくゐん	脚韻	名詞	
きやしや	華奢	名詞	
ぎやぢゆうざぐわ	行住座臥	名詞	
きゆうきよく	嬉遊曲	名詞	嬉遊曲>>喜遊曲
きゆうじゆつ	弓術	名詞	
きゆうでん	宮殿	名詞	
ぎよ	語	名詞	漢音
ぎよ	馭	名詞サ変	
きようい	胸圍	名詞	きようゐ
きようおく	胸臆	名詞	
きようかう	兇行	名詞	兇行>>凶行（國）
きようかつ	恐喝	名詞サ変	機種依存
きようかん	兇漢	名詞	兇漢>>凶漢（國）
きようき	兇器	名詞	兇器>>凶器
きようき	凶器	名詞	兇器>>凶器（國）
きようくわう	恐慌	名詞	
ぎようしふ	凝集	名詞サ変	
きようじん	兇刃	名詞	兇刃>>凶刃（國）
きようじん	凶刃	名詞	兇刃>>凶刃（國）
きようつう	共通	名詞形動	
きようど	匈奴	名詞	
きようばう	兇暴	名詞形動	兇暴>>凶暴（國）
きようふ	恐怖	名詞	
きようへん	兇變	名詞	兇変>>凶変（國）
きようみ	興味	名詞	
きようやく	共軛	名詞形動	共軛>>共役
きようゐ	胸圍	名詞	
きよおく	巨億	名詞	
きよがく	巨嶽	名詞	
きよきん	醵金	名詞	醵金>>拠金
きよくがくあせい	曲學阿世	名詞	
きよくわい	巨魁	名詞	
ぎよくわくだか	漁獲高	名詞	
ぎよくわくりおう	漁獲量	名詞	
ぎよしや	馭者	名詞	馭者>>御者（國）
きよしゆつ	醵出	名詞サ変	醵出>>拠出（他）
ぎよらう	魚撈	名詞	魚撈>>魚労（國）
ぎよをう	漁翁	名詞	
きりうさん	稀硫酸	名詞	稀硫酸>>希硫酸（國）
ぎりやう	伎倆	名詞	伎倆（技倆）>>技量（國）
きわうしやう	既往症	名詞	
ぎゐん	議院	名詞	
きゐん	氣韻	名詞	
きをん	氣温	名詞	
きをん	氣溫	名詞	機種依存
きんくわい	金塊	名詞	
きんくわぎよくでう	金科玉條	名詞	
きんこ	禁錮	名詞	禁錮>>禁固（新）
きんごろう	金語樓	固有名詞	
ぎんしよう	吟誦	名詞サ変	吟誦>>吟唱（國）
きんせい	均斉	名詞	均斉>>均整（新）
きんわう	勤王	名詞	
く	喰	動詞ハ行四段	
く	食	動詞ハ行四段	
くいき	區域	名詞	くゐき
くがく	苦學	名詞サ変	
くくわく	區劃	名詞	区劃>>区画（國）
くさぎ	耘	動詞ラ行五段	
くすり	藥	名詞	
くちえ	口繪	名詞	くちゑ
くちゑ	口繪	名詞	
くつさく	掘鑿	名詞サ変	掘鑿>>掘削（國）
くとう	苦鬭	名詞サ変	機種依存
くなう	苦惱	名詞	
くはは	加は	動詞ラ行五段	
くはへ	加へ	動詞一段	
くはへ	銜へ	動詞一段	
くべつ	區別	名詞サ変	
くぼ	凹	動詞マ行五段	
くまのい	熊の膽	名詞	
くら	藏	名詞	
くらい	くらゐ	名詞	
ぐらむ	瓦	名詞	グラム
くらゐ	位	名詞	
くりかへ	繰返	動詞サ行五段	
くれない	くれなゐ	名詞	
ぐわ	をとり	名詞	單漢字
くわ	渦	名詞	漢音
くわ	瓜	名詞	漢音
くわ	化	名詞	漢音
くわ	寡	名詞	漢音
くわ	科	名詞サ変	單漢字
くわ	果	名詞	單漢字
くわ	火	名詞	單漢字
くわ	禍	名詞	漢音
くわ	禾	名詞	漢音
くわ	花	名詞	漢音
くわ	華	名詞	漢音、花の古い字體
くわ	菓	名詞	單漢字
くわ	課	名詞サ変	單漢字
くわ	嘩	名詞	漢音
くわ	貨	名詞	單漢字
くわ	過	名詞	單漢字
ぐわ	臥	名詞	單漢字
くわ	樺	名詞	漢音
ぐわ	瓦	名詞	漢音
くわ	靴	名詞	單漢字
くわ	鍋	名詞	單漢字
くわ	囮	名詞	慣用
くわ	夥	名詞	漢音
くわ	戈	名詞	單漢字
ぐわ	畫	名詞	單漢字
くわ	蝸	名詞	漢音
くわ	訛	名詞	慣用
ぐわ	訛	名詞	單漢字
くわあふ	花押	名詞	
くわい	塊	名詞	漢音
くわい	壊	名詞	漢音
くわい	廻	名詞	漢音
ぐわい	廻	名詞	呉音
くわい	快	名詞	漢音
くわい	怪	名詞	漢音
くわい	悔	名詞	單漢字
くわい	恢	名詞	單漢字
くわい	懐	名詞	漢音
くわい	魁	名詞	單漢字
くわい	晦	名詞	單漢字
くわい	灰	名詞	單漢字
くわい	掛	名詞	漢音
くわい	潰	名詞	漢音
ぐわい	潰	名詞	呉音
くわい	會	名詞サ変	
くわい	傀	名詞	單漢字、大きい、くぐつ
くわい	壞	名詞	漢音、機種依存
くわい	徊	名詞	漢音
ぐわい	徊	名詞	呉音
くわい	恠	名詞	漢音
くわい	懷	名詞	漢音
くわい	檜	名詞	漢音
くわい	獪	名詞	漢音
くわい	畫	名詞	漢音、ゑがく
くわい	繪	名詞	漢音
ぐわい	繪	名詞	呉音
くわい	誨	名詞	單漢字
くわい	悔	名詞	單漢字、機種依存
くわいい	怪異	名詞	
くわいい	魁偉	名詞	くわいゐ
くわいいう	誨誘	名詞サ変	
ぐわいえん	外緣	名詞	
ぐわいかう	外交	名詞サ変	
くわいかつ	快活	名詞形動	
くわいかふ	魁甲	名詞	
くわいぎ	懐疑	名詞サ変	
くわいき	魁奇	名詞形動	
くわいき	傀奇	名詞	
くわいき	囘歸	名詞	
くわいぎ	懷疑	名詞サ変	機種依存
くわいきう	懐舊	名詞	
くわいきう	懷舊	名詞	機種依存
くわいぐわ	繪畫	名詞	
くわいくわつ	快闊	名詞形動	
くわいくわつ	快濶	名詞形動	快濶>>快活（國）
くわいくわつ	獪猾	名詞形動	
くわいくわん	掛冠	名詞	
くわいけい	塊茎	名詞	
くわいけいくわ	會計課	名詞	
くわいけつ	魁傑	名詞	
くわいけつびやう	壊血病	名詞	
くわいけつびやう	壞血病	名詞	機種依存
ぐわいけん	外見	名詞	
くわいご	悔悟	名詞サ変	
くわいこ	懐古	名詞サ変	
くわいこ	懷古	名詞サ変	機種依存
くわいご	悔悟	名詞サ変	機種依存
くわいこう	恢弘	名詞	
ぐわいこく	外國	名詞	
くわいこん	塊根	名詞	
くわいこん	悔恨	名詞	
くわいこん	悔恨	名詞	機種依存
くわいさく	晦朔	名詞	
くわいし	懐紙	名詞	
くわいし	懷紙	名詞	機種依存
くわいじ	誨示	名詞サ変	
くわいじう	懐柔	名詞	
くわいじう	懷柔	名詞	機種依存
くわいじうさく	懐柔策	名詞	
くわいじうさく	懷柔策	名詞	機種依存
くわいじけん	怪事件	名詞	
くわいじつ	晦日	名詞	
くわいじふ	晦澁	名詞	
くわいしや	會社	名詞	
くわいしや	會社	名詞	機種依存
くわいじやう	塊狀	名詞	
くわいじやう	悔狀	名詞	
くわいしやう	徊飛	名詞	
くわいじやう	悔狀	名詞	機種依存
ぐわいしゆつ	外出	名詞サ変	
くわいしゆん	悔悛	名詞	
くわいしゆん	悔悛	名詞	機種依存
くわいしん	快心	名詞	
くわいせい	快晴	名詞	
ぐわいせき	外戚	名詞	
くわいせん	廻船	名詞	
くわいそう	廻送	名詞サ変	
くわいそう	潰走	名詞サ変	
くわいだん	怪談	名詞	
くわいちゆう	懐中	名詞	
くわいちゆう	懷中	名詞	機種依存
くわいてん	廻轉	名詞サ変	廻転>>回転（國）
ぐわいでん	外傳	名詞	
くわいにん	懐妊	名詞サ変	
くわいにん	懷妊	名詞サ変	機種依存
くわいはう	快方	名詞	
くわいひ	檜皮	名詞	
くわいふうさう	懐風藻	固有名詞	
くわいふうさう	懷風藻	固有名詞	機種依存
くわいふく	恢復	名詞サ変	恢復>>回復（國）
くわいぶつ	怪物	名詞	
くわいぶん	悔文	名詞	
ぐわいぶん	外聞	名詞	
くわいぶん	悔文	名詞	機種依存
くわいほう	快報	名詞	
くわいめい	晦冥	名詞	
くわいめつ	潰滅	名詞サ変	潰滅>>壊滅、負けて滅びること
くわいや	晦夜	名詞	
くわいやう	潰瘍	名詞	
くわいゆう	囘游	名詞サ変	囘游>>回遊
くわいらい	傀儡	名詞	
くわいらう	廻廊	名詞	廻廊>>回廊（國）
くわいらく	快樂	名詞	
くわいらん	廻覽	名詞サ変	
くわいらん	潰亂	名詞サ変	ちりぢりに亂れること
くわいらん	壞亂	名詞サ変	やぶれ亂れること
くわいりき	怪力	名詞	
くわいりき	恠力	名詞	
くわいろ	懐爐	名詞	
くわいろ	懷爐	名詞	機種依存
くわいゐ	魁偉	名詞	
くわう	横	名詞	漢音
くわう	光	名詞	單漢字
くわう	橫	名詞	漢音、機種依存
ぐわうおん	轟音	名詞	
くわうげふ	礦業	名詞	礦業>>鉱業（國）
くわうごう	皇后	名詞	
くわうさう	宏壯	名詞形動	宏壮>>広壮（國）
くわうせき	礦石	名詞	礦石>>鉱石（國）
くわうせん	光線	名詞	
くわうだい	宏大	名詞形動	宏大>>広大（國）
くわうだい	廣大	名詞形動	
くわうたいし	皇太子	名詞	
くわうはん	廣汎	名詞形動	廣汎>>広範（國）
くわうや	曠野	名詞	曠野>>広野（國）
くわえん	火炎	名詞	
くわえん	火焔	名詞	火焔>>火炎（國）
くわえん	火焰	名詞	機種依存
くわえんだいこ	火焔太鼓	名詞	
くわえんだいこ	火焰太鼓	名詞	機種依存
くわおん	訛音	名詞	
ぐわか	畫家	名詞	
ぐわかい	瓦解	名詞	
くわかうがん	花崗岩	名詞	
くわがく	化學	名詞	
くわがく	科學	名詞	
くわかん	果敢	名詞形動	
くわがん	花顔	名詞	
くわき	瓜季	名詞	
くわぎう	蝸牛	名詞	
くわきふ	火急	名詞形動	
くわきよ	科擧	名詞	
くわく	劃	名詞サ変	
くわく	廓	名詞	單漢字
くわく	獲	名詞	漢音
くわく	擴	名詞	ひろめる、單漢字
くわく	攫	名詞	呉音
くわく	畫	名詞	漢音、かぎる、くぎる
くわく	矍	名詞	呉音
くわく	摑	名詞	單漢字
くわくいつ	劃一	名詞形動	
くわくいつ	畫一	名詞形動	
くわくいつくわ	劃一化	名詞	
くわくいつくわ	畫一化	名詞	
くわくいつてき	劃一的	名詞形動	
くわくいつてき	畫一的	名詞形動	
くわくきてき	劃期的	名詞形動	劃期的>>画期的（國）
くわくくわく	矍々	名詞	
くわくさく	畫策	名詞サ変	
くわくさん	擴散	名詞サ変	
くわくしやく	矍鑠	名詞	
くわくじゆう	擴充	名詞サ変	
くわくすう	畫數	名詞	
くわくせいき	擴聲器	名詞	
くわくぜん	劃然	名詞形動	劃然>>画然（國）
くわくぜん	廓然	名詞形動	
くわくだい	廓大	名詞サ変	
くわくだい	擴大	名詞サ変	
くわくちやう	擴張	名詞サ変	
くわくちやうし	擴張子	名詞	
くわくとく	獲得	名詞サ変	
くわけう	華僑	名詞	
くわげん	寡言	名詞	
くわげん	訛言	名詞	
くわこ	過去	名詞	
くわご	訛語	名詞	
くわこく	禾穀	名詞	
くわこん	禍根	名詞	
くわさい	火災	名詞	
くわざい	貨材	名詞	
くわじ	瓜時	名詞	
くわじ	火事	名詞	
くわし	菓子	名詞	
くわじつ	果實	名詞	
くわしつ	過失	名詞サ変	
くわじつ	過日	名詞	
くわしや	花車	名詞	
ぐわしやう	臥床	名詞	
くわしよ	禾黍	名詞	
くわしよいういう	禾黍油油	名詞	
くわしよく	花燭	名詞	
くわしよく	樺燭	名詞	
くわじん	寡人	名詞	
くわしん	花信	名詞	
ぐわしんしやうたん	臥薪嘗胆	名詞	
くわぜい	課税	名詞	
くわせう	嘩笑	名詞サ変	
くわせき	化石	名詞	
くわぜん	果然	名詞形動	
ぐわぜん	瓦全	名詞	
くわだい	課題	名詞	
くわだう	華道	名詞	
くわたう	過當	名詞形動	
くわだん	果斷	名詞形動	
くわだん	花壇	名詞	
ぐわち	活	名詞	呉音
くわち	筈	名詞	呉音
くわち	闊	名詞	呉音
くわちやう	課長	名詞	
くわちゆう	渦中	名詞	
くわつ	活	名詞	漢音
くわつ	滑	名詞	なめらか、漢音
ぐわつ	月	名詞	
くわつ	筈	名詞	漢音
くわつ	闊	名詞	漢音
くわつくう	滑空	名詞サ変	
くわつこ	括弧	名詞	
くわつしや	滑車	名詞	
くわつそう	滑走	名詞サ変	
くわつそうろ	滑走路	名詞	
くわつたく	滑澤	名詞形動	
くわつどう	活動	名詞サ変	
くわつもく	刮目	名詞	
くわつやく	活躍	名詞サ変	
くわつやくきん	括約筋	名詞	
くわつりよく	活力	名詞	
くわてい	過程	名詞	
くわてうふうげつ	花鳥風月	名詞	
くわでん	瓜田	名詞	
くわでん	訛傳	名詞	
くわと	過渡	名詞サ変	
くわど	過度	名詞形動	
くわとき	過渡期	名詞	
くわはん	夥伴	名詞	
くわび	華美	名詞形動	
ぐわびやう	臥病	名詞	
くわふ	寡婦	名詞	
くわふく	禍福	名詞	
くわぶん	寡聞	名詞形動	
くわふん	花粉	名詞	
くわへい	貨幣	名詞	
ぐわべい	畫餅	名詞	
くわべん	花瓣	名詞	
くわほう	果報	名詞	
くわほう	過褒	名詞	
くわほんくわ	禾本科	名詞	
くわもく	寡黙	名詞形動	
くわもつ	貨物	名詞	
くわもん	渦紋	名詞	
くわらう	過勞	名詞	
くわりうかい	花柳界	名詞	
ぐわりよう	臥龍	名詞	
ぐわりようてんせい	畫龍點睛	名詞	
くわれい	華麗	名詞形動	
くわれう	過料	名詞	
ぐわれき	瓦礫	名詞	
くわん	觀	名詞	單漢字
くわんあう	觀櫻	名詞サ変	
くわんあうくわい	觀櫻會	名詞	
くわんいう	勸誘	名詞	
くわんげい	歡迎	名詞	
くわんけい	關係	名詞サ変	
くわんげん	管絃	名詞	管絃>>管弦（國）
くわんげんがく	管絃樂	名詞	管絃楽>>管弦楽（國）
くわんしん	關心	名詞サ変	
くわんろく	貫禄	名詞	貫禄>>貫録（新）
くゐき	區域	名詞	
くをん	久遠	名詞	
くんかい	訓誡	名詞サ変	訓誡>>訓戒（國）
ぐんくわ	軍靴	名詞	
くんくわい	訓誨	名詞サ変	
ぐんくわく	軍擴	名詞サ変	
くんじよう	燻蒸	名詞サ変	燻蒸>>薫蒸（新）
くんせい	燻製	名詞	燻製>>薫製（國）
ぐんゆうかつきよ	群雄割據	名詞	
け	瓜	名詞	呉音
け	寡	名詞	呉音
け	花	名詞	呉音
け	華	名詞	呉音、花の古い字體
げ	華	名詞	呉音、花の古い字體
け	嘩	名詞	呉音
げ	霞	名詞	呉音
け	塊	名詞	呉音
け	壊	名詞	呉音
け	快	名詞	呉音
け	怪	名詞	呉音
げ	悔	名詞	慣用
け	芥	名詞	呉音
げ	蟹	名詞	呉音
げ	外	名詞	呉音
け	掛	名詞	呉音
げ	樺	名詞	呉音
げ	瓦	名詞	呉音
け	假	名詞サ変	呉音
け	傀	名詞	呉音、大きい
け	壞	名詞	呉音、機種依存
け	恠	名詞	呉音
け	檜	名詞	呉音
け	獪	名詞	呉音
げ	畫	名詞	呉音、ゑがく
け	蝸	名詞	呉音
げ	悔	名詞	慣用、機種依存
けいい	經緯	名詞	けいゐ
けいえい	經營	名詞サ変	
けいかう	傾嚮	名詞	傾嚮>>傾向
けいくわ	經過	名詞サ変	
けいくわく	計劃	名詞サ変	計劃>>計画
けいけん	敬虔	名詞形動	敬虔>>敬謙（新）
けいさう	繋爭	名詞	繋爭>>係争（國）
げいじゆつ	藝術	名詞	
げいじゆついん	藝術院	名詞	げいじゆつゐん
げいじゆつゐん	藝術院	名詞	
けいしよう	繼承	名詞サ変	
けいせん	繋船	名詞	繋船>>係船（國）
けいぞく	繋屬	名詞	繋屬>>係属（國）
けいぞく	繼續	名詞サ変	
けいたい	攜帶	名詞サ変	
けいたいでんわ	攜帶電話	名詞	
けいちゆう	契沖	人名	
けいゆ	經由	名詞サ変	
けいりう	繋留	名詞	繋留>>係留（國）
けいれき	經歴	名詞	
けいゐ	經緯	名詞	
けう	教	名詞	單漢字
けう	學	名詞	をしへる、呉音
げう	曉	名詞	
げうあん	曉゛闇	名詞	
けういく	敎育	名詞サ変	
けうかい	教誡	名詞サ変	教へ戒めること。
けうくわ	教科	名詞	
けうくわい	教誨	名詞サ変	（受刑者などに）教へ諭すこと。
けうくわん	叫喚	名詞サ変	
けうせい	矯正	名詞サ変	
けがらはし	穢	形容詞	
げきかう	激昂	名詞サ変	激昂>>激高（新）
げくわ	外科	名詞	
げこくじやう	下尅上	名詞	下尅上>>下克上（國）
げしや	下車	名詞サ変	
けしやう	化粧	名詞	
けしやうひん	化粧品	名詞	
げしゆにん	下手人	名詞	
げじゆん	下旬	名詞	
げだい	外題	名詞	
げだう	外道	名詞	
げち	滑	名詞	なめらか、呉音
げち	渴	名詞	かれる、呉音、機種依存
けつ	渴	名詞	かれる、漢音、機種依存
けつえん	血緣	名詞	
けつかい	決潰	名詞サ変	決潰>>決壊（國）
けつがふ	結合	名詞サ変	
けつかん	缺陥	名詞	
けつき	蹶起	名詞サ変	蹶起>>決起（國）
けつくわ	結果	名詞	
けつくわい	決潰	名詞サ変	
けつじよ	欠如	名詞サ変	
げつしよく	月蝕	名詞	月蝕>>月食（國）
けつべつ	訣別	名詞サ変	訣別>>決別（國）
けびやう	假病	名詞	
けふ	押	名詞	呉音
げふ	業	名詞	
けふ	今日	名詞	
けふあい	狭隘	名詞形動	
けふい	脅威	名詞	けふゐ
けふかつ	脅喝	名詞サ変	機種依存
けふくわい	協會	名詞	
げふむ	業務	名詞	
けふゐ	脅威	名詞	
けらい	家來	名詞	
けん	劍	名詞	單漢字
けんい	權威	名詞	けんゐ
けんいざい	健胃劑	名詞	けんゐざい
げんか	絃歌	名詞	絃歌>>弦歌（國）
けんかう	健康	名詞	
けんかうかつ	肩胛骨	名詞	肩胛骨>>肩甲骨
げんかく	幻覺	名詞	
げんき	元氣	名詞	
げんきよう	元兇	名詞	元兇>>元凶（國）
けんくわ	喧嘩	名詞サ変	
けんさ	檢査	名詞サ変	
けんしゆ	黔首	名詞	庶民、町人
げんせう	減少	名詞サ変	
げんぜん	儼然	名詞	儼然>>厳然（國）
けんそ	嶮岨	名詞形動	嶮岨>>険阻（國）
けんてい	檢定	名詞サ変	
けんぺいりつ	建蔽率	名詞	建蔽率>>建坪率
けんま	研磨	名詞サ変	研磨>>研摩（國）
げんわく	眩惑	名詞サ変	眩惑>>幻惑（新）
けんゐ	權威	名詞	
けんゐざい	健胃劑	名詞	
こう	擴	名詞	うつ、みたす、單漢字
こういん	勾引	名詞サ変	勾引>>拘引（新）
こうえふ	紅葉	名詞	
こうがく	後學	名詞	
こうくわい	後悔	名詞サ変	
こうくわい	後悔	名詞サ変	機種依存
こうざう	搆造	名詞	
こうせつ	後接	名詞サ変	
こうぢよ	扣除	名詞サ変	扣除>>控除（國）
こうちよく	硬直	名詞サ変	
こうはう	弘報	名詞サ変	弘報>>広報（國）
こえ	こゑ	名詞	
こえ	聲	名詞	聲(こゑ)
ごえい	護衞	名詞サ変	
こおう	呼應	名詞サ変	
こかつ	涸渴	名詞サ変	機種依存
こき	古稀	名詞	古稀>>古希（國）
こきやう	故鄕	名詞	
ごぎやう	五行	名詞	
ごぎやうせつ	五行説	名詞	
こきんしふ	古今集	固有名詞	
こくご	國語	名詞	
こくごがく	國語學	名詞	
こくじ	國字	名詞	
こくしよ	酷暑	名詞	
こくすい	國酔	名詞	
こくすいしゆぎ	國粋主義	名詞	
こくすいしゆぎしや	國粋主義者	名詞	
こくぶん	國文	名詞	
こくぶんがく	國文學	名詞	
ごくらく	極樂	名詞	
ここ	此處	名詞	
こころ	意	名詞	
こころ	義	名詞	
こじやう	古城	名詞	
こすもす	秋櫻	名詞	
こせき	古蹟	名詞	古蹟>>古跡（國）
ごだう	誤導	名詞サ変	
こたへ	答	名詞	
こち	滑	名詞	みだす、呉音
こつ	滑	名詞	みだす、漢音
こつかく	骨骼	名詞	骨骼>>骨格（國）
こてんぶんぱふ	古典文法	名詞	
ことのを	琴の緖	名詞	
こひ	戀	名詞	
ごびう	誤謬	名詞	
こふ	劫	名詞	
ごまあへ	胡麻和	名詞	
こよう	雇傭	名詞サ変	雇傭>>雇用（國）
ごらく	娯樂	名詞	
ごらん	御覽	名詞	
こわいろ	聲色	名詞	
こんかう	混淆	名詞	混淆>>混交（國）
こんがうふえ	金剛不壊	名詞	こんがうふゑ
こんがうふえ	金剛不壞	名詞	こんがうふゑ、機種依存
こんがうふゑ	金剛不壊	名詞	
こんがうふゑ	金剛不壞	名詞	機種依存
ごんげ	權化	名詞	
こんげう	今曉	名詞	
ごんごだうだん	言語道斷	名詞	
こんぜん	渾然	名詞	渾然>>混然（新）
こんちゆう	昆蟲	名詞	
こんてい	根柢	名詞	根柢>>根底
こんめい	昏迷	名詞	道理に暗くて、分別の定まらないこと。
こんめい	混迷	名詞	複雑に入り交じって、見通しがつかないこと。
こんらん	混亂	名詞サ変	
こんりふ	建立	名詞サ変	
さ	笑	動詞カ行五段	
さいかく	才覺	名詞	
ざいがく	在學	名詞サ変	
さいくわ	災禍	名詞	
ざいくわ	罪科	名詞	
さいしよ	最初	名詞形動	
ざう	象	名詞	呉音
さう	蒼	名詞	單漢字
さうあい	相愛	名詞サ変	
さうあん	草案	名詞	
さうい	相違	名詞形動	さうゐ
ざうえい	造營	名詞サ変	
さうがふ	綜合	名詞	
ざうがん	象嵌	名詞サ変	象嵌>>象眼（國）
さうくわう	蒼惶	名詞	蒼惶>>倉皇（國）
さうこく	相剋	名詞サ変	相剋>>相克（國）
さうしさうあい	相思相愛	名詞	
ざうしよ	藏書	名詞	
さうしよく	裝飾	名詞サ変	
さうしよくし	裝飾子	名詞	
さうたう	相當	名詞サ変	
さうてい	裝釘	名詞	装釘(幀)>>装丁（國）
さうてい	裝幀	名詞	装釘(幀)>>装丁（國）
さうめつ	掃滅	名詞サ変	はらひのけほろぼすこと
さうめつ	剿滅	名詞サ変	みなごろし
さうやう	掻痒	名詞	
さうら	候	動詞ハ行四段	
さうらふぶん	候文	名詞	
さうゐ	相違	名詞形動	
さかえ	榮	動詞一段	
さかひ	堺	名詞	
さくい	作爲	名詞	さくゐ
さくか	作家	名詞	
さくかく	錯覺	名詞	
さくがん	鑿岩	名詞サ変	鑿岩>>削岩
さくがんき	鑿岩機	名詞	鑿岩機>>削岩機（新）
さくさん	醋酸	名詞	醋酸>>酢酸（國）
さくそう	錯綜	名詞	
さくぢよ	削除	名詞サ変	
さくゐ	作爲	名詞	
さげふ	作業	名詞	
ざし	坐視	名詞サ変	坐視>>座視（國）
ざす	坐洲	名詞サ変	坐洲>>座州（國）
ざせう	坐礁	名詞サ変	坐礁>>座礁（國）
さたう	砂糖	名詞	
さつかく	錯覺	名詞サ変	
ざつくわ	雜貨	名詞	
ざつたふ	雜沓	名詞	雜沓>>雑踏（國）
さつぽろ	札幌	地名	
さとをさ	里長	名詞	
さは	澤	名詞	
ざふに	雜煮	名詞	
さふにふ	插入	名詞サ変	
さふわ	插話	名詞	
さら	攫	動詞ハ行四段	
さゐ	差異	名詞	
さをう	沙翁	名詞	シェークスピア
さんか	參加	名詞サ変	
さんがく	山嶽	名詞	
さんぎやう	讚仰	名詞サ変	讚仰>>賛仰（國）、夫ではなく先
さんくわい	山塊	名詞	
さんくわんわう	三冠王	名詞	
ざんげ	懺悔	名詞	機種依存
さんげん	三絃	名詞	三絃>>三弦（國）
さんごくし	三國志	固有名詞	
さんさ	三叉	名詞	
さんさろ	三叉路	名詞	三叉路>>三差路（新）
さんじ	讚辞	名詞	讚辞>>賛辞（國）
さんじふ	丗	数	
さんすい	撒水	名詞	撒水>>散水（國）
さんたん	讃嘆	名詞サ変	讃嘆>>賛嘆（國）
さんにふ	參入	名詞サ変	
さんび	讚美	名詞サ変	讚美>>賛美（國）
さんぷ	撒布	名詞サ変	撒布>>散布（國）
さんぷ	算譜	名詞	プログラム
さんぷづ	撒布圖	名詞	
しあひ	試合	名詞サ変	
しい	四圍	名詞	しゐ
しう	洲	名詞	洲>>州（國）
しう	收	名詞	漢音
しうあく	醜惡	名詞形動	
しうい	周圍	名詞	しうゐ
じうい	獸醫	名詞	
しうか	蒐荷	名詞	蒐荷>>集荷（國）
しうしふ	蒐集	名詞サ変	コレクション。
しうしふ	收集	名詞サ変	寄せ集めること。「ごみの―」
しうせい	修正	名詞サ変	
じうなん	柔軟	名詞形動	
しうにふ	收入	名詞	
しうぶん	秋分	名詞	
じうりん	蹂躙	名詞サ変	
しうれん	收斂	名詞サ変	
しうゐ	周圍	名詞	
じえい	自營	名詞	
じえい	自衞	名詞サ変	
じえいげふ	自営業	名詞	
じえいたい	自衞隊	名詞	
しかいふ	云爾	名詞	
しかく	視覺	名詞	
じかく	自覺	名詞サ変	
しきやう	詩經	固有名詞	
しきよく	色慾	名詞	色慾>>色欲（國）
しくわ	齒科	名詞	
しくわつ	死活	名詞	
じくわつ	自活	名詞サ変	
しげき	刺戟	名詞サ変	刺戟>>刺激（國）
しけん	試驗	名詞サ変	
しさう	思想	名詞	
じじつ	事實	名詞	
ししやう	支障	名詞	
じしよ	辭書	名詞	
じしよう	自稱	名詞サ変	
しせい	四聲	名詞	
しせき	史蹟	名詞	史蹟>>史跡（國）
したい	屍體	名詞	屍体>>死体（國）
じたい	字體	名詞	
したびらめ	鞋底魚	名詞	
しちぐさ	質種	名詞	質種>>質草（新）
しちてんばつたう	七顛八倒	名詞	七顛八倒>>七転八倒（國）
しぢやう	市場	名詞	
しづか	靜	名詞	
じつかい	十誡	名詞	
じつかう	實行	名詞サ変	
じつげふか	實業家	名詞	
じつげん	實現	名詞サ変	
じつさう	實裝	名詞サ変	
じつし	實施	名詞サ変	
じつよう	實用	名詞	
じてん	自轉	名詞サ変	
じてん	辭典	名詞	
じてんしや	自轉車	名詞	
しながく	科學	名詞	方便
しはつえき	始發驛	名詞	
しはん	紫斑	名詞	紫斑>>紫班（新）
しふ	襲	名詞	漢音
じふ	襲	名詞	呉音
しふ	輯	名詞	輯>>集（國）
しふ	集	名詞	
じふ	十	数	
じふ	入	名詞	漢音
じふおく	十億	名詞	
しふがふ	集合	名詞サ変	
じふぐわつ	十月	名詞	
じふたい	澁滯	名詞サ変	
しふちやく	執着	名詞サ変	
しふちゆう	集中	名詞サ変	
しふちゆう	集注	名詞サ変	
しふとく	習得	名詞サ変	
しふめい	襲名	名詞サ変	
しへう	指標	名詞	
しほ	鹽	名詞	
しほあぢ	鹽味	名詞	
しぼつ	死歿	名詞サ変	死歿>>死沒（國）
しほづけ	鹽漬	名詞	
しものく	下句	名詞	
しや	社	名詞	漢音
じや	社	名詞	呉音
しや	寫	名詞	單漢字
しや	社	名詞	漢音、機種依存
じや	社	名詞	呉音、機種依存
しやう	仕樣	名詞	
しやう	象	名詞	漢音
しやう	正	名詞	
しやうあく	掌握	名詞サ変	
しやういう	倡優	名詞	俳優のこと
しやうが	唱歌	名詞	古い呼び名
しやうか	上下	名詞	
しやうがい	障碍	名詞	障碍>>障害（國）
しやうがいしや	障碍者	名詞	
じやうぎ	情義	名詞	人情と義理のこと。
じやうぎ	情誼	名詞	人とつきあふ上での人情や誠意のこと。
じやうくわ	情火	名詞サ変	
じやうくわく	城廓	名詞	
しやうぐわつ	正月	名詞	
しやうぐん	將軍	名詞	
じやうげ	上下	名詞	
しやうさい	詳細	名詞形動	
じやうしき	常識	名詞	
じやうじゆ	成就	名詞サ変	
しやうしよ	仕樣書	名詞	
しやうじょ	陞叙	名詞	陞叙>>昇叙
じやうず	上手	名詞形動	
じやうぜつ	饒舌	名詞	饒舌>>冗舌
じやうたい	狀態	名詞	
しやうぢき	正直	名詞形動	
しやうばい	商賣	名詞	
しやうへき	障壁	名詞	妨げとなるもののこと。「関税―」
しやうへき	牆壁	名詞	かきとかべと
じやうほう	情報	名詞	
しやうぼふ	正法	名詞	
しやく	釋	名詞	
しやくわい	社會	名詞	
しやしん	寫眞	名詞	
しやほん	寫本	名詞	
しやりやう	車輌	名詞	車輌>>車両（國）
しやをく	社屋	名詞	
しやをく	社屋	名詞	機種依存
しゆ	主	名詞	單漢字
しゆ	朱	名詞	
しゆ	收	名詞	呉音
じゆうおう	從横	名詞	
しゆうくわ	衆寡	名詞	
しゆうけう	宗敎	名詞	
しゆうしけい	終止形	名詞	
じゆうじつ	充實	名詞サ変	
じゆうじゆん	從順	名詞形動	
しゆうそく	終熄	名詞サ変	終熄>>終息（國）
しゆうち	衆知	名詞	
しゆうらく	聚落	名詞	聚落>>集落（國）
しゆうれう	終了	名詞サ変	
じゆうわう	從橫	名詞	機種依存
しゆえい	守衞	名詞	
しゆかんすう	主函數	名詞	main()
しゆぎやう	修行	名詞サ変	
しゆくえき	宿驛	名詞	
しゆくえん	宿緣	名詞	
しゆくせう	縮小	名詞サ変	
しゆくせう	縮少	名詞サ変	
しゆくわい	首魁	名詞	
じゆしん	受信	名詞サ変	
しゆせき	手蹟	名詞	手蹟>>手跡（國）
しゆだい	主題	名詞	
しゆつか	出荷	名詞サ変	
じゆつくわい	述懐	名詞サ変	
じゆつくわい	述懷	名詞サ変	機種依存
じゆつご	術語	名詞	
しゆつせき	出席	名詞サ変	
しゆつりよく	出力	名詞サ変	
しゆとく	取得	名詞サ変	
しゆはふ	手法	名詞	
しゆるい	種類	名詞	
じゆんおう	順應	名詞サ変	
じゆんか	馴化	名詞サ変	馴化>>順化
しゆんさい	駿才	名詞	駿才>>俊才（國）
しゆんしう	春秋	名詞	
しゆんじう	春秋	名詞	
じゆんしゆ	遵守	名詞サ変	遵守>>順守
じゆんせいてう	純正調	名詞	
じゆんせいりつ	純正律	名詞	
しゆんそく	駿足	名詞形動	駿足>>俊足（新）
じゆんたう	順当	名詞形動	
しゆんば	駿馬	名詞	駿馬>>俊馬
じゆんぼく	醇朴	名詞形動	醇朴>>純朴（新）
しゆんめ	駿馬	名詞	駿馬>>俊馬
しよ	書	名詞	
しよいう	所有	名詞	
しようい	稱謂	名詞	しようゐ
しようかく	昇格	名詞サ変	
しようさん	稱讃	名詞サ変	稱(賞)讃>>称(賞)賛（國）
しようじよ	陞叙	名詞	陞叙>>昇叙（國）
しようだく	承諾	名詞サ変	
じようだん	冗談	名詞	
しようにん	證人	名詞	
じようば	乘馬	名詞サ変	
しようり	勝利	名詞サ変	
じようりう	蒸溜	名詞サ変	蒸溜>>蒸留（國）
じようりうすい	蒸溜水	名詞	
しようゐ	稱謂	名詞	
しよかん	書簡	名詞	
しよかん	書翰	名詞	
しよかんぶん	書翰文	名詞	
しよぎやうむじやう	諸行無常	名詞	
しよく	食	名詞	
しよくいき	職域	名詞	しよくゐき
しよくえん	食鹽	名詞	
しよくかく	觸覺	名詞	
しよくざい	食材	名詞	
しよくじ	食餌	名詞	たべもの
しよくじ	食事	名詞サ変	
しよくじれうはう	食餌療法	名詞	食餌療法>>食事療法（新）
しよくじん	蝕甚	名詞	蝕甚>>食尽（國）
しよくひん	食品	名詞	
しよくぶつ	植物	名詞	
しよくもつ	食品	名詞	
しよくよく	食慾	名詞	食慾>>食欲（國）
しよくゐき	職域	名詞	
しよしひやくか	諸子百家	名詞	
しよしや	書寫	名詞サ変	
じよじやう	抒情	名詞	抒情>>叙情（國）
しよせき	書籍	名詞	
しよだう	書道	名詞	
じよどうし	助動詞	名詞	
しよはう	處方	名詞サ変	
しよはうせん	處方箋	名詞	
しより	處理	名詞サ変	
しりあ	敍利亞	地名	
しりぞけ	卻け	動詞一段	
しれう	資料	名詞	
しれん	試煉	名詞	試煉>>試練（國）
しわじよう	過剩	名詞形動	
しゐ	思惟	名詞サ変	
じゐ	示威	名詞	
じゐん	寺院	名詞	
しんあうち	震央地	名詞	
じんい	人爲	名詞	じんゐ
しんがう	信號	名詞	
じんじや	神社	名詞	
しんじゆがひ	眞珠貝	名詞	
しんじゆつ	鍼術	名詞	鍼術>>針術（國）
しんしよく	侵蝕	名詞サ変	侵蝕>>侵食（國）
しんしよく	浸蝕	名詞サ変	浸蝕>>浸食（國）
しんせき	眞蹟	名詞	真蹟>>真跡（國）
しんちやう	伸暢	名詞サ変	伸暢>>伸長（國）
しんとう	滲透	名詞サ変	滲透>>浸透（國）
しんぱく	心搏	名詞	心搏>>心拍
じんもん	訊問	名詞サ変	訊問>>尋問（國）
しんりやく	侵掠	名詞サ変	侵掠>>侵略（國）
しんわう	親王	名詞	
じんゐ	人爲	名詞	
す	吸	動詞ハ行四段	
すあう	素襖	名詞	
すいたい	衰頽	名詞サ変	衰頽>>衰退（國）
すいたふ	出納	名詞	
すいりやう	推諒	名詞	スヰリヤウ
すいりやう	推量	名詞	スヰリヤウ
すう	數	名詞	
すうがく	數學	名詞	
すうがくくわ	數學科	名詞	
すぢ	筋	名詞	
ずつ	づゝ	名詞	ずつ>>づゝ
せいあ	井蛙	名詞	
せいか	聲價	名詞	
せいかく	正覺	名詞	
せいぎよ	制禦	名詞サ変	制馭(禦)>>制御（國）
せいぎよ	制馭	名詞サ変	制馭(禦)>>制御（國）
せいくわ	製菓	名詞	
せいくわ	製靴	名詞	
せいくわげふ	製靴業	名詞	
せいくわつ	生活	名詞サ変	
せいぐわん	誓願	名詞サ変	
せいぐわん	請願	名詞サ変	
せいげふ	正業	名詞	
せいざう	製造	名詞	
せいじ	正字	名詞	
せいじせいかな	正字正假名遣	名詞	
せいじやう	正常	名詞	
せいそく	棲息	名詞	ある場所に棲むこと。生物学では動物についていふ。
せいそく	生息	名詞	生きて生活すること。生物学では植物についていふ。
せいてつ	製鐵	名詞サ変	
せいゐき	西域	名詞	
せう	咲	名詞	
せう	抄	名詞	
せう	笑	名詞	
せうか	銷夏	名詞	銷夏>>消夏（國）
せうがい	生涯	名詞	
せうかう	消耗	名詞サ変	
せうがく	小學	名詞	
せうきやく	銷卻	名詞サ変	銷卻>>消却（國）
せうさう	焦躁	名詞サ変	焦躁>>焦燥（國
せうせつ	小說	名詞	
ぜうぜつ	饒舌	名詞形動	饒舌>>冗舌（新）
せうそく	消息	名詞	
せうちん	銷沈	名詞サ変	銷沈>>消沈（國）
せうねん	少年	名詞	
せうろく	抄録	名詞サ変	
せうをう	蕉翁	人名	
せお	背負	動詞ハ行四段	
せかいぢゆう	世界中	名詞	
せきくわい	石塊	名詞	
せきらんうん	積亂雲	名詞	
ぜつけう	絶叫	名詞サ変	
ぜつさん	絶讃	名詞サ変	絶讃>>絶賛（國）
せつぞく	接續	名詞サ変	
せつてい	設定	名詞サ変	
せつぽふ	說法	名詞	
せふり	捷利	名詞サ変	捷利>>勝利
せま	隘	形容詞	
ぜんあく	善惡	名詞	
せんえい	尖鋭	名詞形動	尖鋭>>先鋭（國）
せんかう	銓考	名詞サ変	しらべ考へること
せんかう	銓衡	名詞サ変	はかり選ぶこと
せんかくしや	先覺者	名詞	
せんくわ	戰禍	名詞	
ぜんくわい	全壊	名詞サ変	まつたくこはれること
ぜんくわい	全潰	名詞サ変	まつたくつぶれること
せんさう	船艙	名詞	船艙>>船倉（國）
せんさう	戰爭	名詞サ変	
せんしう	撰修	名詞	撰修>>選修
せんしふ	撰集	名詞	撰集>>選集
ぜんしふ	全集	名詞	
せんじや	撰者	名詞	撰者>>選者
せんじやう	洗淨	名詞	佛教で、心身を洗ひ清めること。
せんじやう	煽情	名詞	煽情>>扇情（國）
せんせんきようきよう	戰々兢々	名詞	戦々兢々>>戦々恐々（國）
ぜんたい	全體	名詞	
ぜんたいてき	全體的	名詞形動	
せんたく	選擇	名詞サ変	
せんたくし	選擇肢	名詞	
せんたくし	選擇肢	名詞	
せんたん	先端	名詞	長い物の一番端の部分。
せんたん	尖端	名詞	尖った物の先の部分。
せんだん	擅斷	名詞サ変	擅斷>>専断（國）
せんでき	洗滌	名詞	洗つて綺麗にすること。
せんどう	煽動	名詞サ変	煽動>>扇動（國）
せんぺい	尖兵	名詞	尖兵>>先兵（新）
せんぼつ	戰歿	名詞サ変	戦歿>>戦沒（國）
せんもん	專門	名詞形動	
せんもんか	專門家	名詞	
せんりう	川柳	名詞	
せんわう	專横	名詞形動	
せんわう	專橫	名詞形動	機種依存
せんゐ	繊維	名詞	
ぞうか	增加	名詞サ変	
そうがふ	綜合	名詞サ変	綜合>>総合（國）
そうくわつ	綜括	名詞サ変	
そうくわつ	總括	名詞サ変	
そうざい	惣菜	名詞	惣菜>>総菜（國）
ぞうよ	贈與	名詞サ変	
そうり	總理	名詞	
ぞうを	憎惡	名詞サ変	
ぞうを	憎惡	名詞サ変	機種依存
ぞく	屬	名詞サ変	
ぞく	續	名詞	
ぞくせい	簇生	名詞サ変	簇生>>族生（國）
そぐわい	疎外	名詞サ変	
そこ	其處	名詞	
そこぢから	底力	名詞	
そこな	害	動詞ハ行四段	
そさう	沮喪	名詞サ変	沮喪>>阻喪（國）
そし	沮止	名詞サ変	沮止>>阻止（國）
そしよう	訴訟	名詞サ変	
そすい	疏水	名詞	疏水>>疎水（國）
そつう	疏通	名詞サ変	疏通>>疎通（國）
そめい	疏明	名詞	いひわけ、疏明>>疎明（國）
たい	對	名詞サ変	
たい	體	名詞	呉音
たいいく	體育	名詞	
だいがく	大學	名詞	
だいかく	大覺	名詞サ変	
だいかつ	大喝	名詞サ変	機種依存
たいかふ	太閤	名詞	
たいけい	體系	名詞	
たいけいてき	體系的	名詞	
たいさう	體操	名詞サ変	
たいしつ	體質	名詞	
たいしつてき	體質的	名詞形動	
たいしやう	大將	名詞	
たいしやう	對象	名詞	
たいしよく	褪色	名詞	褪色>>退色（國）
たいせい	頽勢	名詞	頽勢>>退勢（國）
だいぢやうぶ	大丈夫	名詞形動	
だいづ	大豆	名詞	
たいとう	擡頭	名詞サ変	擡頭>>台頭（新）
たいはい	頽廢	名詞サ変	頽廢>>退廃（國）
たいひ	對比	名詞サ変	
たいふう	颱風	名詞	颱風>>台風（國）
だいほん	臺本	名詞	
たいやう	太陽	名詞	
たいよく	大慾	名詞	大慾>>大欲（國）
たいわう	對應	名詞サ変	
たう	堂	名詞	漢音
だう	堂	名詞	呉音
たう	當	名詞	
たうぎん	當今	名詞	現在の天皇陛下の事
たうくわい	倒潰	名詞サ変	倒れつぶれること、倒潰>>倒壊（國）
たうくわい	韜晦	名詞	
たうげ	峠	名詞	
たうけん	刀劍	名詞	
たうこん	當今	名詞	
たうじ	當時	名詞	
たうぜん	當前	名詞形動	
たうぜん	當然	名詞形動	
だうにふ	導入	名詞サ変	
たうぶん	當分	名詞	
たうらう	蟷螂	名詞	
だうろ	道路	名詞	
たかね	高嶺	名詞	
たかねのはな	高嶺の花	名詞	高嶺の花>>高根の花
だくてん	濁點	名詞	
たくわ	多寡	名詞	
ただ	糺	動詞サ行五段	糺>>糾（國）
たたか	鬭	動詞ハ行四段	機種依存
たちあ	立會	動詞ハ行四段	
たちあひにん	立會人	名詞	
たづね	溫ね	動詞一段	機種依存
だつりやく	奪掠	名詞サ変	奪掠>>奪略（國）
たてがき	縱書	名詞サ変	
たのし	樂	形容詞	
たのし	樂	動詞マ行五段	
たふ	答	名詞	單漢字
たふしふ	蹈襲	名詞サ変	蹈襲>>踏襲（國）
たふべん	答辯	名詞サ変	
たまのを	玉の緖	名詞	
たん	歎	動詞ザ変	歎>>嘆（國）
だんがい	彈劾	名詞	
だんかつ	斷割	名詞サ変	
たんくわう	炭礦	名詞	炭礦>>炭鉱（國）
たんくわうぶし	炭礦節	名詞	
たんぐわん	歎願	名詞サ変	歎願>>嘆願（國）
たんご	單語	名詞	
だんこ	斷乎	名詞	断乎>>断固
たんざ	端坐	名詞サ変	端坐>>端座（國）
たんじゆん	單純	名詞形動	
だんてい	斷定	名詞サ変	
だんばう	煖房	名詞	煖房>>暖房（國）
たんへん	短篇	名詞	短篇>>短編（國）
たんぺん	短篇	名詞	短篇>>短編（國）
だんぺん	斷片	名詞	
だんろ	煖炉	名詞	煖炉>>暖炉（國）
ちうざう	鑄造	名詞サ変	
ちうしゆつ	抽出	名詞サ変	
ちうしよく	晝食	名詞	
ちうせん	抽籤	名詞サ変	抽籤>>抽選（新）
ちえ	知惠	名詞	ちゑ
ちえ	智慧	名詞	
ちかく	知覺	名詞サ変	
ちかぢか	近々	名詞	
ちくわん	置換	名詞サ変	
ぢしん	地震	名詞	
ちたい	地帶	名詞	
ちぢ	縮	動詞マ行五段	
ちづ	地圖	名詞	
ちのう	智能	名詞	智能>>知能（國）
ちぼう	智謀	名詞	智謀>>知謀（國）
ぢめん	地面	名詞	
ちやうかく	聽覺	名詞	
ちやうくわ	長靴	名詞	
ちやうし	長子	名詞	
ちやうしよく	朝食	名詞	
ぢやうせき	定石	名詞	
ちやうちん	堤燈	名詞	
ちやうにん	町人	名詞	
ぢやうぶ	丈夫	名詞形動	
ちやうへん	長篇	名詞	長篇>>長編（國）
ちやくわ	茶菓	名詞	
ちゆう	註	名詞	註>>注（國）
ちゆう	蟲	名詞	
ちゆうあう	中央	名詞	
ちゆうかい	註解	名詞サ変	註解>>注解（國）
ちゆうがく	中學	名詞	
ちゆうき	註記	名詞サ変	
ちゆうくわ	中華	名詞	
ちゆうごく	中國	地名	差別用語
ちゆうごくじん	中國人	固有名詞	差別用語
ちゆうし	中止	名詞サ変	
ちゆうしやく	註釈	名詞	註釈>>注釈
ちゆうしやく	註釋	名詞サ変	
ちゆうしん	衷心	名詞	
ちゆうたい	繃帶	名詞	
ぢゆうみん	住民	名詞	
ちゆうもん	注文	名詞サ変	
ちゆうもん	註文	名詞サ変	
ぢゆうやく	重役	名詞	
ちゆうらうい	中勞委	名詞	ちゆうらうゐ
ちゆうらうゐ	中勞委	名詞	
ぢよい	女醫	名詞	
ちよくご	直後	名詞	
ぢよぐわい	除外	名詞サ変	
ぢよせい	女性	名詞	
ぢよせい	女婿	名詞	
ちり	埃	名詞	
ちゐき	地域	名詞	
ぢんあい	塵埃	名詞	
ぢんえい	陣營	名詞	
ちんこん	鎭魂	名詞	
ちんじ	珍事	名詞	めずらしい出來事。
ちんじ	椿事	名詞	思ひがけない大変な出來事。
ちんでん	沈澱	名詞サ変	沈澱>>沈殿（國）
つ	亞	動詞ガ行五段	
づ	圖	名詞	
ついて	就て	名詞	
つういん	痛飮	名詞サ変	
つうくわ	通貨	名詞	
つうくわ	通過	名詞サ変	
つか	使	動詞ハ行四段	
つかひかた	使ひ方	名詞	
づぐわ	圖畫	名詞	
つじせつぽう	辻說法	名詞	
つたは	傳は	動詞ラ行五段	
つたへ	傳へ	動詞一段	
づつ	づゝ	名詞	
づつう	頭痛	名詞	
つづき	續	名詞	
つひえ	潰え	動詞一段	
つひえ	費	名詞	
つひや	費	動詞サ行五段	
つぶら	圓	名詞形動	
つゆくさ	鴨跖	名詞	
であ	出會	動詞ハ行四段	
であひ	出會	名詞	
てい	體	名詞	漢音
ていか	定家	名	
ていか	定價	名詞	
ていくわい	低徊	名詞サ変	{彳低-イ}徊>>低回（國）
ていしよく	牴觸	名詞サ変	牴(觝)觸>>抵触（國）
ていしよく	觝觸	名詞サ変	牴(觝)觸>>抵触（國）
ていちよう	鄭重	名詞形動	鄭重>>丁重（國）
ていねい	叮嚀	名詞形動	叮嚀>>丁寧（國）
ていばう	堤防	名詞	
ていはく	碇泊	名詞サ変	碇泊>>停泊（國）
ていわう	帝王	名詞	
てうい	弔慰	名詞サ変	てうゐ
てうかん	鳥瞰	名詞サ変	鳥瞰>>鳥観
てうかんづ	鳥瞰圖	名詞	鳥瞰図>>鳥観図（新）
てうさ	調査	名詞サ変	
てうし	調子	名詞	
てうせん	朝鮮	地名	
てうせんせいばつ	朝鮮征伐	名詞	
でうちゆう	絛蟲	名詞	絛虫>>条虫
てうづ	手水	名詞	
てうゐ	弔慰	名詞サ変	
でき	出來	動詞一段	
てきがふ	適合	名詞サ変	
てちやう	手帳	名詞	
てつがく	哲學	名詞	
てつだう	鐵道	名詞	
てつぱう	鐵砲	名詞	
ててふ	手帖	名詞	
でんいう	電郵	名詞	
でんき	電氣	名詞	
てんくわ	轉訛	抑制単語	
てんごく	天國	名詞	
てんたう	顚倒	名詞サ変	顚倒>>転倒（國）
てんちくわいめい	天地晦冥	名詞	
てんでん	輾轉	名詞サ変	
てんでんはんそく	輾轉反側	名詞	輾轉反側>>展転反側
でんとう	傳統	名詞	
でんぶ	臀部	名詞	臀部>>殿部（他）
てんぷく	顚覆	名詞サ変	顚覆>>転覆（國）
でんぷん	澱粉	名詞	澱粉>>殿粉（他）
でんぶん	傳聞	名詞	
てんまつ	顚末	名詞	
てんわう	天王	名詞	
てんわう	天皇	名詞	
てんわう	天皇陛下	名詞	
と	問	動詞ハ行四段	
といふ	都邑	名詞	
とうあ	東亞	地名	
どうえう	童謠	名詞	
とうか	等價	名詞形動	
とうかち	等價値	名詞	
とうくわ	燈火	名詞	
とうくわつ	統括	名詞サ変	
どうてん	動顚	名詞サ変	
とえい	都營	名詞	
とくがく	篤學	名詞	
どくじ	獨自	名詞形動	
とくしふ	特輯	名詞サ変	特輯>>特集（國
どくしや	讀者	名詞	
どくしよ	讀書	名詞サ変	
どくわい	土塊	名詞	
としや	醫者	名詞	
とぜつ	杜絶	名詞サ変	杜絶>>途絶（國）
とばり	幄	名詞	
とばりのざ	幄の座	名詞	
とへはたへ	十重二十重	名詞	
とほ	通	動詞ラ行五段	
とほ	闊	動詞ラ行五段	
とほかがみ	古今集遠鏡	固有名詞	
ともな	伴	動詞ハ行四段	
とりあへず	取敢ず	名詞	
ないがん	内含	名詞サ変	
ないぐわい	内外	名詞	
ないざう	內臟	名詞	
なう	腦	名詞	
なふにふ	納入	名詞サ変	
なまへ	名前	名詞	
なみ	浪	名詞	
なんゐ	南緯	名詞	
にうわ	柔和	名詞	
にくくわい	肉塊	名詞	
にじふ	廿	数	
にちえう	日曜	名詞	
につき	日記	名詞	
につくわ	日課	名詞	
につしよく	日蝕	名詞	
にふ	入	名詞	呉音
にふいん	入院	名詞	にふゐん
にふか	入荷	名詞サ変	
にふがく	入學	名詞サ変	
にふもん	入門	名詞サ変	
にふりよく	入力	名詞サ変	
にふりよくき	入力器	名詞	
にふゐん	入院	名詞	
にほんしよき	日本書紀	固有名詞	
にゆうくわ	乳菓	名詞	
にゆうさん	乳酸	名詞	
にんぎやう	人形	名詞	
にんずう	人數	名詞	
ぬくも	溫も	動詞ラ行五段	機種依存
ぬる	溫	形容詞	機種依存
ぬる	溫	動詞マ行五段	機種依存
ねが	願	動詞ハ行四段	
ねつきやう	熱狂	名詞サ変	
ねんぐわん	念願	名詞	
の	飮	動詞マ行五段	
のこ	殘	動詞サ行五段	
のぼ	陞	動詞ラ行五段	陞>>昇（國）
のりかへ	乘換	動詞一段	
はい	貝	名詞	單漢字
ばいう	黴雨	名詞	黴雨>>梅雨（他）
はいき	廢棄	名詞サ変	
はいきよ	廢墟	名詞	廢墟>>廃虚（新）
はいくわい	徘徊	名詞サ変	
ばいたい	媒體	名詞	
はいとく	悖徳	名詞	悖徳>>背徳（國）
ばいどく	黴毒	名詞	黴毒>>梅毒（他）
ばいべん	買辦	名詞	買辦（辛二つの間に力）>>買弁
はいりよ	配慮	名詞サ変	
はいれつ	排列	名詞サ変	排列>>配列
はう	方	名詞	
はう	法	名詞	漢音
はう	旁	名詞	漢音
ばう	旁	名詞	呉音
ばうあつ	防遏	名詞	防遏>>防圧（新）
はうい	包圍	名詞サ変	はうゐ
ばうえい	防衞	抑制単語	
ばうがい	妨害	名詞	相手に危害を加えて物事の遂行を妨げること。
ばうがい	妨碍	名詞サ変	道に物を置いて通行を妨げること。
はうかう	芳香	名詞	
はうがく	方角	名詞	
はうき	放棄	名詞サ変	なげすてる
はうき	抛棄	名詞サ変	なげすてる、すておく
ばうぎよ	防禦	名詞サ変	防禦>>防御（國）
はうくわい	抱懐	名詞サ変	
はうくわい	抱懷	名詞サ変	機種依存
はうくわつ	包括	名詞サ変	
はうさう	放送	名詞サ変	
はうしや	放射	名詞サ変	
はうじゆん	芳醇	名詞形動	芳醇>>芳純（新）
ばうせき	紡績	名詞	
ばうだい	膨大	動詞サ変	サ変動詞で、膨れて大きくなること。
ばうだい	厖大	名詞形動	形容動詞で、量や規模が大きいさま。
はうたい	繃帶	名詞	繃帶>>包帯（國）
はうちやう	庖丁	名詞	庖丁>>包丁（國）
ばうちやう	膨脹	名詞サ変	膨脹>>膨張
はうぶつ	抛物	名詞	
はうぶつせん	抛物線	名詞	抛物線>>放物線（國）
はうむ	葬	動詞ラ行五段	
はうりつ	法律	名詞	
はうゐ	包圍	名詞サ変	
はえ	榮	抑制単語	
はき	破棄	名詞サ変	契約・取り決めなどを一方的に取り消すこと。
はき	破毀	名詞サ変	法律用語で、上級裁判所が、上訴を理由ありと認め原判決を取り消すこと。
はくあ	白堊	名詞	白堊>>白亜
はくかう	薄倖	名詞	薄倖>>薄幸（國）
はくちう	白晝	名詞	
はくどう	搏動	名詞サ変	搏動>>拍動
ばくろ	曝露	名詞サ変	曝露>>暴露（國）
はくわい	破壊	名詞サ変	
はくわい	破壞	名詞	機種依存
ばけがく	化學	名詞	方便
ばしよ	場所	名詞	
はすい	破摧	名詞サ変	破摧>>破砕（國）
はぢ	恥	名詞	
はづ	外	動詞サ行五段	
はついく	發育	名詞	
はつおん	發音	名詞サ変	
はつおんびん	撥音便	名詞	
はつが	發芽	名詞	
はつかう	醗酵	名詞サ変	醗酵>>発酵（國）
はつかく	發覺	名詞サ変	
はつくわ	發火	名詞サ変	
ばつすい	抜萃	名詞サ変	抜萃>>抜粋（國）
はつせい	發生	名詞サ変	
はつせい	發聲	名詞サ変	
はつめい	發明	名詞サ変	
はづれ	外れ	動詞一段	
はてんくわう	破天荒	名詞	
はなぢ	鼻血	名詞	
はなみち	花道	名詞	
はなを	鼻緖	名詞	
はにふ	埴生	名詞	
はひ	灰	名詞	
はふ	法	名詞	呉音
はまき	葉卷	名詞	
はらん	波瀾	名詞形動	波瀾>>波乱（新）
はんい	範圍	名詞	はんゐ
はんえい	繁榮	名詞サ変	
はんおう	反應	名詞サ変	
ばんがう	番號	名詞	
はんき	叛旗	名詞	叛旗>>反旗（國）
はんぎやく	叛逆	名詞サ変	叛逆>>反逆（國）
ばんきん	鈑金	名詞	
はんくわ	繁華	名詞	
はんくわい	半潰	名詞サ変	
はんけい	半徑	名詞	
ばんしう	晩秋	名詞	
はんしよく	蕃殖	名詞サ変	蕃殖>>繁殖（國）
ばんぞく	蕃族	名詞	蕃族>>蛮族（國）
はんてん	斑點	名詞	斑點>>班点（新）
はんぱつ	反撥	名詞サ変	反撥>>反発（國）
はんらん	叛亂	名詞サ変	叛乱>>反乱（國）
はんゐ	範圍	名詞	
ひうが	日向	地名	
ひきすう	引數	名詞	
ひけつ	秘訣	名詞	
ひご	蜚語	名詞サ変	蜚語>>飛語（國）
ひさい	菲才	名詞形動	菲才>>非才
びせう	微笑	名詞サ変	
ひつえう	必要	名詞	
ひつくわ	筆禍	名詞	
ひつしや	筆者	名詞	
ひつせき	筆蹟	名詞	筆蹟>>筆跡（國）
ひとへ	一重	名詞	
びは	琵琶	名詞	
びやういん	病院	名詞	びやうゐん
ひやうか	評價	名詞サ変	
びやうき	病氣	名詞形動	
びやうぐわ	病臥	名詞	
ひやうそく	平仄	名詞	
びやうぼつ	病歿	名詞サ変	病歿>>病沒（國）
びやうゐん	病院	名詞	
ひやく	百	数	
ひら	挨	動詞カ行五段	
ひら	頁	助数詞	
ひれき	披瀝	名詞サ変	披瀝>>披歴（新）
ひろ	闊	形容詞	
ひろう	披露	名詞サ変	
ひろの	曠野	名詞	曠野>>広野（國）
ひをけ	火桶	名詞	
ひんきゆう	貧窮	名詞サ変	
びんばふ	貧乏	名詞	
ふ	蹈	動詞マ行五段	蹈>>踏（國）
ふうくわうめいび	風光明媚	名詞形動	風光明媚>>風光明美（新）
ふうし	諷刺	名詞サ変	諷刺>>風刺（國）
ふうゆ	諷喩	名詞	諷喩>>風諭
ふうゐん	風韻	名詞	
ふえう	不要	名詞	
ふえん	布衍	名詞サ変	布衍>>敷延（新）
ふえん	敷衍	名詞サ変	敷衍>>敷延（新）
ふがう	符號	名詞	
ふかく	不覺	名詞形動	
ぶかつかう	不恰好	名詞形動	不恰好>>不格好（新）
ふぐあひ	不具合	名詞	エラー
ふくくわつ	復活	名詞サ変	
ふくざは	福澤	姓	
ふくしや	複寫	名詞サ変	
ふくすう	複數	名詞	
ふくろう	ふくろふ	名詞	
ふくろおび	袋帶	名詞	
ふくわい	不快	名詞形動	
ふしやう	負傷	名詞サ変	
ふしよく	腐蝕	名詞サ変	腐蝕>>腐食（國）
ぶだう	葡萄	名詞	
ふたへまぶた	二重瞼	名詞	
ふだん	不斷	名詞	
ふたん	負擔	名詞サ変	
ふぢ	藤	名詞	
ふち	緣	名詞	
ふぢさは	藤澤	地名	
ふぢなみ	藤波	名詞	
ふぢなみ	藤浪	名詞	
ぶつか	物價	名詞	
ぶつざう	佛像	名詞	
ぶつよく	物慾	名詞	物慾>>物欲（國）
ふてふ	符牒	名詞	符牒>>符丁（國）
ふらん	腐爛	名詞サ変	腐爛>>腐乱（國）
ふんいき	雰圍氣	名詞	
ぶんがく	文學	名詞	
ぶんくわ	文化	名詞	
ふんさう	扮裝	名詞サ変	扮裝>>粉装
ぶんしやう	文章	名詞	
ぶんしよ	文書	名詞	
ふんぬ	匈奴	名詞	
ぶんぱふ	文法	名詞	
ぶんみやく	文脈	名詞	
ぶんりう	分溜	名詞サ変	分溜>>分留
へいくわ	兵戈	名詞	
へいをん	平隱	名詞形動	
へう	票	名詞	
へう	表	名詞	
へうい	表意	名詞	
へうき	表記	名詞サ変	
べうぎ	廟議	名詞	
べうぐわ	描畫	名詞サ変	
へうげん	表現	名詞サ変	
へうじ	表示	名詞サ変	
べうしや	描寫	名詞サ変	
へうじゆん	標準	名詞	
へうぜん	飄然	名詞	飄然>>漂然（新）
へうほん	標本	名詞	
へこ	凹	動詞マ行五段	
へり	緣	名詞	
べん	辨	名詞	わかち。わきまへ。あつかひ。
べん	辧	名詞	辨の異字體。
べん	瓣	名詞	はなびら。なかご。機械のベン。
べん	辮	名詞	くむ。あむ。
べん	辯	名詞	いひまはし。言葉遣。口先が巧みなこと。
べん	麪	名詞	麺の正字
べん	辦	名詞	なす、力を致すこと。そなふ、そなはる。
へんかう	變更	名詞サ変	
へんきやう	邊疆	名詞	邊疆>>辺境（國）
へんくわ	變化	名詞サ変	
へんくわん	變換	名詞サ変	
へんげ	變化	名詞サ変	
へんしふ	編輯	名詞サ変	編輯>>編集（國）
へんじやうくわ	遍上靴	名詞	
へんすう	變數	名詞	
へんづつう	偏頭痛	名詞	偏頭痛>>片頭痛（他）
べんぱつ	辮髪	名詞	辮髪>>弁髪
へんぺい	扁平	名詞	扁平>>偏平
ほいく	保育	名詞サ変	乳幼児を保護し育てること。
ほいく	哺育	名詞サ変	哺育>>保育（國）
ほいくえん	哺育園	名詞	ほいくゑん、哺育>>保育（國）
ほいくゑん	哺育園	名詞	哺育>>保育（國）
ほうきふ	俸給	名詞	
ほうくわい	崩潰	名詞サ変	崩潰>>崩壊（國）
ほうじ	捧持	名詞サ変	捧持>>奉持（新）
ほうしゆく	奉祝	名詞	
ほうねん	豐年	名詞	
ほうふ	豐富	名詞形動	
ぼくじふ	墨汁	名詞	
ほくわく	捕獲	名詞サ変	
ほくゐ	北緯	名詞	
ほけん	保險	名詞	
ほこり	埃	名詞	
ほさ	輔佐	名詞サ変	輔佐>>補佐（國）
ほさう	鋪裝	名詞サ変	鋪裝>>舗装（國）
ぼし	拇指	名詞	拇指>>母指（新）
ほしいひ	干飯	名詞	
ほだう	輔導	名詞サ変	輔導>>補導（國）
ほふえ	法會	名詞	ほふゑ
ほふゑ	法會	名詞	
ほぼ	保姆	名詞	保姆>>保母（國）
ほらがひ	法螺貝	名詞	
ほるい	堡塁	名詞	堡塁>>保塁（新）
ほるもん	抛物	名詞	ホルモン>>抛る物
ほゐ	補遺	名詞	
ほんくわい	本懐	名詞形動	
ほんくわい	本懷	名詞	機種依存
ほんしよ	本書	名詞	
ぼんぢやうちん	盆堤燈	名詞	
ほんぱう	奔放	名詞形動	
ほんやく	飜譯	名詞サ変	
まい	まゐ	動詞ラ行五段	
まい	參	動詞ラ行五段	まゐる
まうあ	盲啞	名詞	
まうさう	妄想	名詞サ変	妄想>>盲想（新）
まうしふ	妄執	名詞サ変	妄執>>盲執（新）
まうどう	妄動	名詞サ変	妄動>>盲動（國）
まうねん	妄念	名詞	妄念>>盲念（新）
まかう	磨耗	名詞サ変	磨耗>>摩耗（新）
まくあひ	幕間	名詞	
まづ	先づ	名詞	
まつか	眞赤	名詞形動	
まつさを	眞つ靑	名詞形動	
まど	惑	動詞ハ行四段	
まどか	圓	名詞	
まどぐち	窗口	名詞	
まは	廻	動詞ラ行五段	
まは	囘	動詞ラ行五段	
まはり	廻	名詞	
まはり	囘	名詞	
まへ	前	名詞	
まへかは	前川	姓	
まめつ	磨滅	名詞サ変	磨滅>>摩滅（國）
まよ	迷	動詞ハ行四段	
まる	圓	形容詞	
まわ	廻	動詞ラ行五段	
まゐ	參	動詞ラ行五段	
まんえふしふ	萬葉集	固有名詞	
みあうきゆう	未央宮	名詞	
みこ	皇子	名詞	
みだり	濫	名詞形動	
みづ	水	名詞	
みづあか	水垢	名詞	
みづぐわし	水菓子	名詞	
みやくはく	脈愽	名詞	脈愽>>脈拍（新）
みんえう	民謠	名詞	
みんしゆくわ	民主化	名詞サ変	
むい	無爲	名詞	むゐ
むくわんしん	無關心	名詞	
むし	蟲	名詞	
むじゆん	矛盾	名詞サ変	
むち	無智	名詞形動	無智>>無知（國）
むめ	梅	名詞	
むよく	無慾	名詞形動	無慾>>無欲（國）
むらをさ	村長	名詞	
むゐ	無爲	名詞	
めいい	名醫	名詞	
めいがく	名嶽	名詞	
めいくわ	名花	名詞	
めいくわい	明快	名詞形動	
めいび	明媚	名詞	明媚>>明美
めいよ	名譽	名詞	
めいよきそん	名譽毀損	名詞	名譽毀損>>名誉棄損（新）
めいよよく	名譽慾	名詞	名譽慾>>名誉欲（國）
めいらう	明朗	名詞形動	
めう	妙	名詞形動	
めぐりあひ	邂逅	名詞	
めづらし	珍	形容詞	
めん	麪	名詞	麺の正字
めんか	棉花	名詞	棉花>>綿花（國）
もさく	摸索	名詞サ変	摸索>>模索（國）
もち	十五日	名詞	
もちい	用ゐ	動詞一段	
もんだいぐわい	問題外	名詞形動	
もんだふ	問答	名詞サ変	
や	舍	名詞	
やう	央	名詞	漢音
やう	櫻	名詞	呉音
やう	鶯	名詞	呉音
やうか	八日	名詞	
やうす	樣子	名詞	
やうぢやう	横笛	名詞	
やうぢやう	橫笛	名詞	機種依存
やうでう	横笛	名詞	
やうでう	橫笛	名詞	機種依存
やうやう	洋々	名詞	
やくざいし	藥劑師	名詞	
やじう	野獸	名詞	
やしよく	夜食	名詞	
やしろ	社	名詞	機種依存
やひ	野鄙	名詞形動	野鄙>>野卑（國）
やへざくら	八重櫻	名詞	
ゆいま	維摩	人名	
ゆいまきやう	維摩經	名詞	
ゆう	有	名詞サ変	
ゆうき	勇氣	名詞	
ゆうぎ	友誼	名詞	友誼>>友宜（新）
ゆうぜん	悠然	名詞	悠然>>裕然
ゆくわい	愉快	名詞形動	
ゆさうせん	油槽船	名詞	油槽船>>油送船（新）
ゆたか	豐	名詞形動	
ゆふ	夕	名詞	
ゆふがた	夕方	名詞	
ゆふしよく	夕食	名詞	
ゆふひ	夕日	名詞	
よ	緣	動詞ラ行五段	
よいん	餘韻	名詞	
よう	鷹	名詞	漢音
よう	應	名詞	漢音
ようかい	鎔解	名詞サ変	鎔解>>溶解（國）
ようがん	熔岩	名詞	熔岩>>溶岩（國）
ようせつ	熔接	名詞サ変	熔接>>溶接
ようはふ	用法	名詞	
よか	餘暇	名詞	
よく	臆	名詞	漢音
よく	慾	名詞	慾>>欲
よこ	橫	名詞	機種依存
よこく	預告	名詞サ変	
よこく	豫告	名詞サ変	
よすが	緣	名詞	
よち	餘地	名詞	
よてい	預定	名詞サ変	
よてい	豫定	名詞サ変	
よみ	嘉	動詞サ行五段	
よみかき	讀書	名詞サ変	
よみこ	讀込	動詞マ行五段	
よみと	讀取	動詞ラ行五段	
よみとり	讀取	名詞	
よろづ	萬	名詞	
よろん	輿論	名詞	輿論>>世論
よゐん	餘韻	名詞	
らう	狼	名詞	單漢字
らう	勞	名詞	
らうか	廊下	名詞	
らうがい	癆咳	名詞	
らうくわい	老獪	名詞形動	
らうどう	勞働	名詞	
らうをう	老翁	名詞	
らくえん	樂園	名詞	らくゑん
らくか	落下	名詞サ変	
らくくわ	落花	名詞	
らくくわん	樂觀	名詞サ変	
らくくわんてき	樂觀的	名詞形動	
らくご	落伍	名詞サ変	落伍>>落後（新）
らくしよう	樂勝	名詞サ変	
らくてん	樂天	名詞	
らくてんてき	樂天的	名詞形動	
らくばん	落磐	名詞	落磐>>落盤（國）
らくゑん	樂園	名詞	
らふそく	蠟燭	名詞	
らんくつ	濫掘	名詞サ変	濫掘>>乱掘
らんざう	濫造	名詞サ変	濫造>>乱造
らんさく	濫作	名詞サ変	濫作>>乱作
らんどく	濫讀	名詞サ変	濫読>>乱読
らんぱつ	濫發	名詞	濫發>>乱発
らんぴ	濫費	名詞サ変	濫費>>乱費
らんよう	濫用	名詞サ変	濫用>>乱用
らんわう	卵黃	名詞	
りうい	留意	名詞サ変	
りういき	流域	名詞	りうゐき
りういん	溜飲	名詞	溜飲>>留飲（新）
りうかう	流行	名詞サ変	
りうげんひご	流言蜚語	名詞	
りうさん	硫酸	名詞	
りうしゆつ	溜出	名詞	溜出>>留出
りうゐき	流域	名詞	
りえう	俚謠	名詞	俚謠>>里謡（國）
りかう	悧巧	名詞形動	心の働がが素早くたくみ
りくつ	理窟	名詞	理窟>>理屈（國）
りくわ	理科	名詞	
りくわい	理解	名詞サ変	内容、意味などが分かること。
りくわい	理會	名詞サ変	理會>>理解、物事の道理を會得すること。
りこう	悧口	名詞形動	悧口>>利口
りち	理智	名詞	理智>>理知（國）
りつぱう	立方	名詞	
りつぱうたい	立方體	名詞	
りはん	離叛	名詞サ変	離叛>>離反（國）
りふし	粒子	名詞	
りやうかい	諒解	名詞	まこととして認めること
りやうしよう	諒承	名詞サ変	諒承>>了承（國）
りやくだつ	掠奪	名詞サ変	掠奪>>略奪（國）
りゆう	龍	名詞	
りゆうせい	隆盛	名詞	
りよう	龍	名詞	
りんくわく	輪廓	名詞	輪廓>>輪郭（國）
りんじゆう	臨終	名詞	
れいぐわい	例外	名詞形動	
れいくわい	例會	名詞	
れいぢやう	令孃	名詞	
れいほう	靈峰	名詞	
れうかい	了解	名詞サ変	能く理解すること
れうけん	了簡	名詞	了簡＊・料簡>>了見（新）
れうけん	料簡	名詞	了簡＊・料簡>>了見（新）
れうしよう	了承	名詞サ変	うけたまはること
れふじゆう	獵銃	名詞	
れんか	廉價	名詞	
れんがふ	聯合	名詞サ変	聯合>>連合（國）
れんぐわ	煉瓦	名詞	
れんけい	連繋	名詞サ変	連繋>>連係（國）
れんざ	連坐	名詞サ変	連坐>>連座（國）
れんじゆ	聯珠	名詞	聯珠>>連珠（國）
れんたいけい	連體形	名詞	
れんたん	煉炭	名詞	煉炭>>練炭（國）
れんにゆう	煉乳	名詞	煉乳>>練乳（國）
れんぱう	聯邦	名詞	聯邦>>連邦（國）
れんぽう	聯峰	名詞	
れんま	練磨	名詞サ変	練（錬）磨>>練摩（新）
れんま	錬磨	名詞サ変	練（錬）磨>>練摩（新）
れんめい	聯盟	名詞サ変	聯盟>>連盟（國）
れんらく	聯絡	名詞サ変	聯絡>>連絡（國）
れんりつ	聯立	名詞サ変	聯立>>連立（國）
ろう	樓	名詞	
ろうあ	聾啞	名詞	
ろうでん	漏電	名詞	
ろうをく	陋屋	名詞	
ろくでふ	六疊	名詞	
わ	渦	名詞	呉音
わ	禍	名詞	呉音
わ	禾	名詞	呉音
わ	夥	名詞	呉音
わう	往	名詞	單漢字
わう	旺	名詞	單漢字
わう	横	名詞	呉音
わう	王	名詞	
わう	橫	名詞	呉音、機種依存
わう	黃	名詞	
わういつ	横溢	名詞サ変	
わういつ	橫溢	名詞サ変	機種依存
わうぎやく	横逆	名詞形動	
わうぎやく	橫逆	名詞形動	機種依存
わうぐわ	横臥	名詞サ変	
わうぐわ	橫臥	名詞サ変	機種依存
わうじ	往時	名詞	
わうし	横死	名詞サ変	
わうじ	王子	名詞	
わうし	橫死	名詞サ変	機種依存
わうじやう	往生	名詞サ変	
わうしやう	王將	名詞	
わうしん	往診	名詞サ変	
わうせい	旺盛	名詞形動	
わうだん	横斷	名詞サ変	
わうだん	橫斷	名詞サ変	機種依存
わうて	王手	名詞	
わうてう	王朝	名詞	
わうねん	往年	名詞	
わうふく	往復	名詞サ変	
わうらい	往來	名詞	
わうりやう	横領	名詞サ変	
わうりやう	橫領	名詞サ変	機種依存
わうわう	往々	名詞	
わき	和氣	名詞	
わきあいあい	和氣靄靄	名詞形動	
わく	獲	名詞	呉音
わく	畫	名詞	呉音、かぎる、くぎる
わけ	訣	名詞	
わけ	訳	名詞	訣の假借
わしたかくわ	鷲鷹科	名詞	
わら	咲	動詞ハ行四段	
わら	笑	動詞ハ行四段	
わらぢ	草鞋	名詞	
わらぢ	鞋	名詞	
わる	悪	名詞	
わん	彎	名詞	彎>>湾（國）
わんきよく	彎曲	名詞サ変	彎曲>>湾曲（國）
わんにふ	彎入	名詞サ変	彎入>>湾入（國）
ゐ	葦	名詞	
ゐ	位	名詞	單漢字
ゐ	偉	名詞	
ゐ	委	名詞	
ゐ	威	名詞	
ゐ	尉	名詞	
ゐ	惟	名詞	單漢字
ゐ	畏	名詞	
ゐ	胃	名詞	
ゐ	井	名詞	
ゐ	亥	名詞	
ゐ	居	動詞一段	
ゐ	鮪	名詞	單漢字
ゐ	帷	名詞	單漢字
ゐ	膽	名詞	
ゐあく	帷幄	名詞	
ゐあつ	威壓	名詞サ変	
ゐあん	慰安	名詞サ変	
ゐいう	畏友	名詞	
ゐいん	委員	名詞	
ゐかく	威嚇	名詞サ変	
ゐがん	胃癌	名詞	
ゐかん	遺憾	名詞形動	
ゐぎ	威儀	名詞	
ゐき	遺棄	名詞サ変	
ゐきない	域内	名詞	
ゐきよく	委曲	名詞	
ゐくわくちやう	胃擴張	名詞	
ゐくわん	偉觀	名詞形動	
ゐくわんそく	維管束	名詞	
ゐけい	畏敬	名詞	
ゐげふ	偉業	名詞	
ゐげん	威嚴	名詞	
ゐけん	違憲	名詞	
ゐげん	遺言	名詞	
ゐご	圍碁	名詞	
ゐこつ	遺骨	名詞	
ゐこん	遺恨	名詞	
ゐさい	偉才	名詞	
ゐさい	委細	名詞	
ゐさいかま	委細構	動詞ハ行四段	
ゐさん	胃酸	名詞	
ゐさん	遺産	名詞	
ゐじ	維持	名詞サ変	
ゐじ	遺兒	名詞	
ゐしつ	遺失	名詞サ変	
ゐしや	葦車	名詞	
ゐしや	慰籍	名詞サ変	
ゐじやく	胃弱	名詞	
ゐしやれう	慰藉料	名詞	慰藉料>>慰謝料
ゐしゆく	萎縮	名詞サ変	
ゐしよ	遺書	名詞	
ゐしよく	委嘱	名詞サ変	
ゐじん	偉人	名詞	
ゐしん	威信	名詞	
ゐしん	維新	名詞サ変	
ゐせい	威勢	名詞	
ゐせい	爲政	名詞	
ゐせいしや	爲政者	名詞	
ゐせき	葦席	名詞	
ゐせき	遺蹟	名詞	
ゐせき	井堰	名詞	
ゐせん	緯線	名詞	
ゐだい	偉大	名詞形動	
ゐたく	委託	名詞	
ゐたけだか	威丈高	名詞形動	
ゐちやう	胃腸	名詞	
ゐぢやうふ	偉丈夫	名詞	
ゐづつ	井筒	名詞	
ゐでん	遺傳	名詞サ変	
ゐど	緯度	名詞	
ゐど	井戸	名詞	
ゐどし	亥年	名詞	
ゐにん	委任	名詞サ変	
ゐのこ	豕	名詞	
ゐのしし	猪	名詞	
ゐば	威張	動詞ラ行五段	
ゐはい	違背	名詞	
ゐはう	違法	名詞形動	
ゐばく	帷幕	名詞	
ゐはん	違反	名詞サ変	
ゐびやう	胃病	名詞	
ゐふ	畏怖	名詞サ変	
ゐぶつ	遺物	名詞	
ゐもん	慰問	名詞サ変	
ゐやく	違約	名詞サ変	
ゐよう	偉容	名詞形動	
ゐらう	慰勞	名詞サ変	
ゐりよく	威力	名詞	
ゐれい	慰靈	名詞サ変	
ゐれいさい	慰靈祭	名詞	
ゐろり	圍爐裏	名詞	
ゐわ	違和	名詞	
ゐゐ	惟々	名詞	
ゐん	韻	名詞	
ゐんがう	院號	名詞	
ゐんせい	院政	名詞	
ゐんせい	隕星	名詞	
ゐんせき	隕石	名詞	
ゐんてつ	隕鐵	名詞	
ゐんない	院内	名詞	
ゐんぶん	韻文	名詞	
ゐんりつ	韻律	名詞	
ゑ	餌	名詞	
ゑ	壊	名詞	呉音
ゑ	懐	名詞	呉音
ゑ	酔	動詞ハ行四段	
ゑ	囘	名詞	呉音
ゑ	懷	名詞	呉音、機種依存
ゑ	繪	名詞	呉音
ゑかう	廻向	名詞	
ゑくぼ	靨	名詞	
ゑそ	壊疽	名詞	
ゑそ	壞疽	名詞	機種依存
ゑそらごと	繪空言	名詞	
ゑづ	繪圖	名詞	
ゑとき	繪解	名詞	
ゑほん	繪本	名詞	
を	於	名詞	音
を	牡	名詞	
を	折	動詞ラ行五段	
を	尾	名詞	
を	雄	名詞	
を	嗚	名詞	漢音
を	惡	名詞	
を	緖	名詞	
をう	翁	名詞	單漢字
をうし	牡牛	名詞	
をうし	雄牛	名詞	
をか	岡	名詞	
をか	丘	名詞	
をか	侵	動詞サ変	
をか	犯	動詞サ行五段	
をか	冒	動詞サ変	
をか	陸	名詞	
をが	拜	動詞マ行五段	
をかし	可笑	形容詞	
をかしらつき	尾頭付	名詞	
をがは	小川	名詞	
をかん	惡寒	名詞	
をぎ	荻	名詞	
をく	屋	名詞	單漢字
をくか	屋下	名詞	
をくぐわい	屋外	名詞	
をくじやう	屋上	名詞	
をけ	桶	名詞	
をけや	桶屋	名詞	
をさ	長	名詞	
をさな	幼	形容詞	
をざは	小澤	姓	
をさま	治ま	動詞ラ行五段	
をさま	修ま	動詞ラ行五段	
をさま	統ま	動詞ラ行五段	
をさま	納ま	動詞ラ行五段	
をさま	收ま	動詞ラ行五段	
をさめ	治め	動詞一段	
をさめ	修め	動詞一段	
をさめ	統め	動詞一段	
をさめ	納め	動詞一段	
をし	愛	動詞マ行五段	
をし	惜	動詞マ行五段	
をし	誨	動詞ハ行四段	
をじか	牡鹿	名詞	
をしへ	教へ	動詞一段	
をしべ	雄蕊	名詞	
をしへ	誨へ	動詞一段	
をたけび	雄叫び	名詞	
をつと	夫	名詞	
をど	躍	動詞ラ行五段	
をど	踊	動詞ラ行五段	
をとこ	男	名詞	
をとこぎ	男氣	名詞	
をとこじよたい	男所帶	名詞	
をとこまへ	男前	名詞	
をとり	囮	名詞	
をね	尾根	名詞	
をの	斧	名詞	
をのの	戰	動詞カ行五段	
をは	終	動詞ラ行五段	
をば	小母	名詞	
をは	卒	動詞ラ行五段	
をは	畢	動詞ラ行五段	
をは	了	動詞ラ行五段	
をばな	雄花	名詞	
をひ	甥	名詞	
をひれ	尾鰭	名詞	
をり	折	名詞	
をり	檻	名詞	
をりづめ	折詰	名詞	
をりばこ	折箱	名詞	
ををし	雄々し	形容詞	
ををは	尾を張	動詞ラ行五段	
ををひ	尾を引	動詞カ行五段	
をん	温	名詞	單漢字
をん	隱	名詞	呉音
をん	溫	名詞	單漢字、機種依存
をんき	遠忌	名詞	
をんこう	温厚	名詞形動	
をんこう	溫厚	名詞形動	機種依存
をんこちしん	温故知新	名詞	
をんこちしん	溫故知新	名詞	機種依存
をんしふ	温習	名詞サ変	
をんしふ	溫習	名詞サ変	機種依存
をんせん	温泉	名詞	
をんせん	溫泉	名詞	機種依存
をんぞん	温存	名詞サ変	
をんぞん	溫存	名詞サ変	機種依存
をんたう	隱當	名詞形動	
をんだん	温暖	名詞形動	
をんだん	溫暖	名詞形動	機種依存
をんだん	溫煖	名詞形動	溫煖>>溫煖
をんど	溫度	名詞	
をんどり	雄鶏	名詞	
をんな	女	名詞	
をんびん	隱便	名詞形動	
をんる	遠流	名詞	
をんわ	隱和	名詞形動	
