けんさ	検査	抑制単語	
ていねい	丁寧	抑制単語	叮嚀→丁寧（國）
ていちょう	丁重	抑制単語	鄭重→丁重（國）
しちてんばっとう	七転八倒	抑制単語	七顛八倒→七転八倒（國）
まんようしゅう	万葉集	抑制単語	
さんさ	三差	抑制単語	
さんさろ	三差路	抑制単語	三叉路→三差路（新）
さんげん	三弦	抑制単語	三絃→三弦（國）
げこくじょう	下克上	抑制単語	下尅上→下克上（國）
ぶかっこう	不格好	抑制単語	不恰好→不格好（新）
ふよう	不要	抑制単語	
あたえ	与え	抑制単語	
あずか	与	抑制単語	
かんりゅう	乾留	抑制単語	乾溜→乾留（國）
りょうしょう	了承	抑制単語	
りょうけん	了見	抑制単語	了簡＊・料簡→了見（新）
よこく	予告	抑制単語	
じじつ	事実	抑制単語	
ごぎょう	五行	抑制単語	
ごぎょうせつ	五行説	抑制単語	
ありゅう	亜流	抑制単語	
あねったい	亜熱帯	抑制単語	
あねったい	亜熱帯植物	抑制単語	
ありゅうさん	亜硫酸	抑制単語	
あじあ	亜細亜	抑制単語	
あえん	亜鉛	抑制単語	
あま	亜麻	抑制単語	
こうさ	交差	抑制単語	交叉→交差（國）
こうさてん	交差点	抑制単語	
こうかん	交歓	抑制単語	交驩→交歓（國）
きょうおんな	京女	抑制単語	
あおむ	仰向	抑制単語	
きかく	企画	抑制単語	企劃→企画（國）
つたえ	伝え	抑制単語	
でんとう	伝統	抑制単語	
でんぶん	伝聞	抑制単語	
しんちょう	伸長	抑制単語	伸暢→伸長（國）
ていかい	低回	抑制単語	{彳低-イ}徊→低回（國）
たいけい	体系	抑制単語	
たいしつ	体質	抑制単語	
よいん	余韻	抑制単語	
きょうえん	供宴	抑制単語	饗宴→供宴（新）
きょうおう	供応	抑制単語	饗応→供応（國）
かち	価値	抑制単語	
あたい	価	抑制単語	
しんりゃく	侵略	抑制単語	侵掠→侵略（國）
しんしょく	侵食	抑制単語	侵蝕→侵食（國）
けいそう	係争	抑制単語	繋争→係争（國）
けいぞく	係属	抑制単語	繋属→係属（國）
けいりゅう	係留	抑制単語	繋留→係留（國）
けいせん	係船	抑制単語	繋船→係船（國）
しゅんさい	俊才	抑制単語	駿才→俊才（國）
しゅんそく	俊足	抑制単語	駿足→俊足（新）
ほるい	保塁	抑制単語	堡塁→保塁（新）
ほぼ	保母	抑制単語	保姆→保母（國）
しんごう	信号	抑制単語	
そうこう	倉皇	抑制単語	蒼惶→倉皇（國）
とうかい	倒壊	抑制単語	倒潰→倒壊（國）
あたい	値	抑制単語	
ゆうしゅん	優俊	抑制単語	優駿→優俊馬（新）
せんぺい	先兵	抑制単語	尖兵→先兵（新）
せんえい	先鋭	抑制単語	尖鋭→先鋭（國）
ぜんたい	全体	抑制単語	
ぜんたいてき	全体的	抑制単語	
じょうぜつ	冗舌	抑制単語	饒舌→冗舌（新）
しゃしん	写真	抑制単語	
しょり	処理	抑制単語	
きょうぼう	凶暴	抑制単語	兇暴→凶暴（國）
きょうかん	凶漢	抑制単語	兇漢→凶漢（國）
きょうこう	凶行	抑制単語	兇行→凶行（國）
であい	出会	抑制単語	
でき	出来	抑制単語	
りこう	利口	抑制単語	
せいぎょ	制御	抑制単語	制馭(禦)→制御（國）
しげき	刺激	抑制単語	刺戟→刺激（國）
さくがん	削岩	抑制単語	
さくがんき	削岩機	抑制単語	鑿岩機→削岩機（新）
まえかわ	前川	抑制単語	
こうか	効果	抑制単語	
こうかてき	効果的	抑制単語	
こうりつ	効率	抑制単語	
こうよう	効用	抑制単語	
ほうちょう	包丁	抑制単語	庖丁→包丁（國）
ほうたい	包帯	抑制単語	繃帯→包帯（國）
かがく	化学	抑制単語	
くべつ	区別	抑制単語	
くかく	区画	抑制単語	区劃→区画（國）
いしゃ	医者	抑制単語	
いやく	医薬	抑制単語	
きべん	危弁	抑制単語	詭弁→危弁（新）
げんぜん	厳然	抑制単語	儼然→厳然（國）
ゆうぎ	友宜	抑制単語	友誼→友宜（新）
はんらん	反乱	抑制単語	叛乱→反乱（國）
はんき	反旗	抑制単語	叛旗→反旗（國）
はんぱつ	反発	抑制単語	反撥→反発（國）
しゅうれん	収斂	抑制単語	
しゅうしゅう	収集	抑制単語	蒐集→収集（國）
とりあえず	取り敢えず	抑制単語	
じょじょう	叙情	抑制単語	抒情→叙情（國）
はんぎゃく	叛逆	抑制単語	叛逆→反逆（國）
こき	古希	抑制単語	古稀→古希（國）
こせき	古跡	抑制単語	古蹟→古跡（國）
きょうかん	叫喚	抑制単語	
かわいそう	可哀相	抑制単語	
かわい	可愛	抑制単語	
だいほん	台本	抑制単語	
たいとう	台頭	抑制単語	擡頭→台頭（新）
たいふう	台風	抑制単語	颱風→台風（國）
しせき	史跡	抑制単語	史蹟→史跡（國）
あいず	合図	抑制単語	
あいふく	合服	抑制単語	
ごうり	合理	抑制単語	
ごうりてき	合理的	抑制単語	
あいかぎ	合鍵	抑制単語	
あいごま	合駒	抑制単語	
めいよきそん	名誉棄損	抑制単語	名誉毀損→名誉棄損（新）
めいよよく	名誉欲	抑制単語	名誉慾→名誉欲（國）
ぎんしょう	吟唱	抑制単語	吟誦→吟唱（國）
あじつけ	味付け	抑制単語	
あじつけ	味付	抑制単語	
あじわ	味わ	抑制単語	
あじ	味	抑制単語	
あじけ	味気	抑制単語	
あじみ	味見	抑制単語	
わき	和気	抑制単語	
わあいあい	和気藹々	抑制単語	
あえもの	和え物	抑制単語	
あえもの	和物	抑制単語	
あいしょう	哀傷	抑制単語	
あいとう	哀悼	抑制単語	
あいしゅう	哀愁	抑制単語	
あいかん	哀歓	抑制単語	
あいがん	哀願	抑制単語	
おし	唖	抑制単語	
あぜん	唖然	抑制単語	
ぜんあく	善悪	抑制単語	
あえ	喘	抑制単語	重税に喘ぐ
きっすい	喫水	抑制単語	吃水→喫水（國）
たんがん	嘆願	抑制単語	歎願→嘆願（國）
しせい	四声	抑制単語	
かいろう	回廊	抑制単語	廻廊→回廊（國）
かいふく	回復	抑制単語	恢復→回復（國）
かいてん	回転	抑制単語	廻転→回転（國）
ず	図	抑制単語	
こくぶんがく	国文学	抑制単語	
こくぶん	国文	抑制単語	
こくごがく	国語学	抑制単語	
こくご	国語	抑制単語	
ず	圖	抑制単語	
きんせい	均整	抑制単語	均斉→均整（新）
あいじん	埃塵	抑制単語	
しおあじ	塩味	抑制単語	
じんあい	塵埃	抑制単語	
ぞうお	増悪	抑制単語	
かいらん	壊乱	抑制単語	潰乱→壊乱（國）
かいめつ	壊滅	抑制単語	潰滅→壊滅（國）
くわいめつ	壞滅	抑制単語	こはれて滅びること
へんか	変化	抑制単語	
へんかん	変換	抑制単語	
へんすう	変数	抑制単語	
ゆうしょく	夕食	抑制単語	
やしょく	夜食	抑制単語	
おおはば	大幅	抑制単語	
たいよく	大欲	抑制単語	大慾→大欲（國）
きべん	奇弁	抑制単語	詭弁→奇弁（新）
きけい	奇形	抑制単語	畸形→奇形（國）
きだん	奇談	抑制単語	綺談→奇談（國）
きせき	奇跡	抑制単語	奇蹟→奇跡（國）
ほうじ	奉持	抑制単語	捧持→奉持（新）
だつりゃく	奪略	抑制単語	奪掠→奪略（國）
こうお	好悪	抑制単語	
ぼうがい	妨害	抑制単語	妨碍→妨害（國）
ばいたい	媒体	抑制単語	
がくせい	学生	抑制単語	
がくしゃ	学者	抑制単語	
がくしゃ	学舎	抑制単語	
じつげん	実現	抑制単語	
じつよう	実用	抑制単語	
たいおう	対応	抑制単語	
たいひ	対比	抑制単語	
たいしょう	対象	抑制単語	
せんだん	専断	抑制単語	擅断→専断（國）
せんもんか	専門家	抑制単語	
せんもん	専門	抑制単語	
じんもん	尋問	抑制単語	訊問→尋問（國）
どうにゅう	導入	抑制単語	
ついて	就いて	抑制単語	
ほうかい	崩壊	抑制単語	崩潰→崩壊（國）
きたい	希代	抑制単語	稀代→希代（國）
きげんそ	希元素	抑制単語	稀元素→希元素（國）
きしょう	希少	抑制単語	稀＊少→希少（國）
きりゅうさん	希硫酸	抑制単語	稀硫酸→希硫酸（國）
きはく	希薄	抑制単語	稀薄→希薄（國）
きしゃく	希釈	抑制単語	稀釈→希釈（國）
きのう	帰納	抑制単語	
きのうほう	帰納法	抑制単語	
きのうてき	帰納的	抑制単語	
じょうしき	常識	抑制単語	
まくあい	幕間	抑制単語	
かんてん	干天	抑制単語	旱天→干天（國）
かんがい	干害	抑制単語	旱害→干害（國）
ひょうそく	平仄	抑制単語	
げんわく	幻惑	抑制単語	眩惑→幻惑（新）
こうそう	広壮	抑制単語	宏壮→広壮（國）
こうだい	広大	抑制単語	宏大→広大（國）
こうはん	広範	抑制単語	広汎→広範（國）
こうや	広野	抑制単語	曠野→広野（國）
ひろの	広野	抑制単語	曠野→広野（國）
ざす	座州	抑制単語	坐洲→座州（國）
ざしょう	座礁	抑制単語	坐礁→座礁（國）
ざし	座視	抑制単語	坐視→座視（國）
はいきょ	廃虚	抑制単語	廃墟→廃虚（新）
げんか	弦歌	抑制単語	絃歌→弦歌（國）
きょうこ	強固	抑制単語	鞏固→強固（國）
ごうよく	強欲	抑制単語	強慾→強欲（國）
とうぎん	当今	抑制単語	
とうぶん	当分	抑制単語	
あたりまえ	当たり前	抑制単語	
あた	当た	抑制単語	
あて	当て	抑制単語	
とうじ	当時	抑制単語	
とうぜん	当然	抑制単語	
ぎょしゃ	御者	抑制単語	馭者→御者（國）
ひつよう	必要	抑制単語	
かいかつ	快活	抑制単語	快濶→快活（國）
あくじ	悪事	抑制単語	
あくに	悪人	抑制単語	
あくい	悪意	抑制単語	
あくかんじょう	悪感情	抑制単語	
あくせん	悪戦	抑制単語	
あくせんくとう	悪戦苦闘	抑制単語	
あく	悪	抑制単語	
あくひつ	悪筆	抑制単語	
あくせん	悪銭	抑制単語	
わる	惡	抑制単語	
いと	意図	抑制単語	
あいこう	愛好	抑制単語	
あいきょう	愛敬	抑制単語	
あいぎょう	愛敬	抑制単語	
あいがん	愛玩	抑制単語	
あいしょう	愛称	抑制単語	
あいどく	愛読	抑制単語	
あいどくしょ	愛読書	抑制単語	
ぞうお	憎悪	抑制単語	
せんせんきょうきょう	戦々恐々	抑制単語	戦々兢々→戦々恐々（國）
せんぼつ	戦沒	抑制単語	戦歿→戦沒（國）
せんどう	扇動	抑制単語	煽動→扇動（國）
せんじょう	扇情	抑制単語	煽情→扇情（國）
おおぎ	扇	抑制単語	
あお	扇	抑制単語	
しゅせき	手跡	抑制単語	手蹟→手跡（國）
ぎりょう	技量	抑制単語	技倆→技量（國）
しょうろく	抄録	抑制単語	
ばっすい	抜粋	抑制単語	抜萃→抜粋（國）
ひれき	披歴	抑制単語	披瀝→披歴（新）
ていしょく	抵触	抑制単語	牴(觝)触→抵触（國）
ちゅうせん	抽選	抑制単語	抽籤→抽選（新）
こういん	拘引	抑制単語	勾引→拘引（新）
きょしゅつ	拠出	抑制単語	醵出→拠出（他）
そうにゅう	挿入	抑制単語	
しょうあく	掌握	抑制単語	
くっさく	掘削	抑制単語	掘鑿→掘削（國）
せつぞく	接続	抑制単語	
こうじょ	控除	抑制単語	扣除→控除（國）
すいりょう	推量	抑制単語	
びょうしゃ	描写	抑制単語	
びょうが	描画	抑制単語	
あくりょく	握力	抑制単語	
あくしゅ	握手	抑制単語	
けいたい	携帯	抑制単語	
けいたいでんわ	携帯電話	抑制単語	
まめつ	摩滅	抑制単語	磨滅→摩滅（國）
まもう	摩耗	抑制単語	磨耗→摩耗（新）
ししょう	支障	抑制単語	
ほうき	放棄	抑制単語	抛棄→放棄（國）
ほうぶつせん	放物線	抑制単語	抛物線→放物線（國）
こう	效	抑制単語	
きょうかい	教戒	抑制単語	教誨→教戒（國）
あえて	敢えて	抑制単語	
さんぷず	散布図	抑制単語	
さんぷ	散布	抑制単語	撒布→散布（國）
さんすい	散水	抑制単語	撒水→散水（國）
けいけん	敬謙	抑制単語	敬虔→敬謙（新）
すうがく	数学	抑制単語	
すうがくか	数学科	抑制単語	
ふえん	敷延	抑制単語	敷衍＊・布衍→敷延（新）
ぶんぽう	文法	抑制単語	
だんてい	断定	抑制単語	
ほうがく	方角	抑制単語	
ぞくせい	族生	抑制単語	簇生→族生（國）
にっしょく	日食	抑制単語	
きゅうせき	旧跡	抑制単語	旧蹟→旧跡（國）
しょうじょ	昇叙	抑制単語	陞叙→昇叙（國）
えいが	映画	抑制単語	
ちゅうしょく	昼食	抑制単語	
あかつき	暁	抑制単語	
ぎょう	暁	抑制単語	
ぎょうあん	暁闇	抑制単語	
だんぼう	暖房	抑制単語	煖房→暖房（國）
だんろ	暖炉	抑制単語	煖炉→暖炉（國）
ばくろ	暴露	抑制単語	曝露→暴露（國）
きょくがくあせい	曲学阿世	抑制単語	
こうせい	更正	抑制単語	更正
しょしゃ	書写	抑制単語	
しょ	書	抑制単語	
しょかん	書簡	抑制単語	書翰→書簡（國）
しょかんぶん	書簡文	抑制単語	
しょどう	書道	抑制単語	
かい	會	抑制単語	
げっしょく	月食	抑制単語	月蝕→月食（國）
ゆうこう	有効	抑制単語	
ちょうしょく	朝食	抑制単語	
ほんらい	本来	抑制単語	
しゅ	朱	抑制単語	
とうあ	東亜	抑制単語	
あずま	東	抑制単語	
あずまおとこ	東男	抑制単語	
あずまおどり	東踊り	抑制単語	
こかつ	枯渇	抑制単語	涸渇→枯渇（國）
こうせい	校正	抑制単語	
こんてい	根底	抑制単語	根柢→根底（國）
かっこう	格好	抑制単語	恰好→格好（新）
かっぷく	格幅	抑制単語	恰幅→格幅（新）
かくとう	格闘	抑制単語	挌闘→格闘（國）
ばいどく	梅毒	抑制単語	黴毒→梅毒（他）
ばいう	梅雨	抑制単語	黴雨→梅雨（他）
きそん	棄損	抑制単語	毀損→棄損（新）
もさく	模索	抑制単語	摸索→模索（國）
きょうとうほ	橋頭保	抑制単語	橋頭堡→橋頭保（新）
きち	機知	抑制単語	機智→機知（國）
きのうほう	機能法	抑制単語	
けっかん	欠陥	抑制単語	
かがく	歌学	抑制単語	
かしゅう	歌集	抑制単語	
ここ	此処	抑制単語	
したい	死体	抑制単語	屍体→死体（國）
しぼつ	死沒	抑制単語	死歿→死沒（國）
のこ	残	抑制単語	
でんぷん	殿粉	抑制単語	澱粉→殿粉（他）
でんぶ	殿部	抑制単語	臀部→殿部（他）
ぼし	母指	抑制単語	拇指→母指（新）
きえん	気炎	抑制単語	気焔→気炎（國）
きはく	気迫	抑制単語	気魄→気迫（新）
みずあか	水垢	抑制単語	
けつべつ	決別	抑制単語	訣別→決別（國）
けっかい	決壊	抑制単語	決潰→決壊（國）
けっき	決起	抑制単語	蹶起→決起（國）
ちんでん	沈殿	抑制単語	沈澱→沈殿（國）
さわ	沢	抑制単語	
ゆそうせん	油送船	抑制単語	油槽船→油送船（新）
はらん	波乱	抑制単語	波瀾→波乱（新）
ちゅうもん	注文	抑制単語	註文→注文（國）
ちゅうかい	注解	抑制単語	註解→注解（國）
ちゅうしゃく	注釈	抑制単語	註釈→注釈（國）
かっぱつ	活発	抑制単語	活溌→活発（國）
あさましさ	浅ましさ	抑制単語	
あさましげ	浅ましげ	抑制単語	
あさまし	浅まし	抑制単語	
あさはか	浅はか	抑制単語	
あさめ	浅め	抑制単語	
あさ	浅	抑制単語	
あさみどり	浅緑	抑制単語	
あさみどりいろ	浅緑色	抑制単語	
あさぎ	浅葱	抑制単語	
あさぎ	浅黄	抑制単語	
しんとう	浸透	抑制単語	滲透→浸透（國）
しんしょく	浸食	抑制単語	浸蝕→浸食（國）
しょうか	消夏	抑制単語	銷夏→消夏（國）
しょうちん	消沈	抑制単語	銷沈→消沈（國）
しょうもう	消耗	抑制単語	
こんらん	混乱	抑制単語	
こんこう	混交	抑制単語	混淆→混交（國）
こんぜん	混然	抑制単語	渾然→混然（新）
おんど	温度	抑制単語	
おんだん	温暖	抑制単語	
おんせん	温泉	抑制単語	
わんにゅう	湾入	抑制単語	彎入→湾入（國）
わん	湾	抑制単語	彎→湾（國）
わんきょく	湾曲	抑制単語	彎曲→湾曲（國）
ようがん	溶岩	抑制単語	熔岩→溶岩（國）
ようかい	溶解	抑制単語	鎔解→溶解（國）
ひょうぜん	漂然	抑制単語	飄然→漂然（新）
さわ	澤	抑制単語	
げきこう	激高	抑制単語	激昂→激高（新）
だくてん	濁点	抑制単語	
くわえん	火炎	抑制単語	火焔→火炎（國）
あかし	灯	抑制単語	
たんんこう	炭鉱	抑制単語	炭礦→炭鉱（國）
たんこうぶし	炭鉱節	抑制単語	
むよく	無欲	抑制単語	無慾→無欲（國）
むち	無知	抑制単語	無智→無知（國）
むかんしん	無関心	抑制単語	
しょうそう	焦燥	抑制単語	焦躁→焦燥（國
あお	煽	抑制単語	
へんずつう	片頭痛	抑制単語	偏頭痛→片頭痛（他）
ぶつよく	物欲	抑制単語	物慾→物欲（國）
とくしゅう	特集	抑制単語	特輯→特集（國
じょうたい	状態	抑制単語	
きょうげん	狂言	抑制単語	
どくじ	独自	抑制単語	
きょうあい	狭隘	抑制単語	
はんてん	班点	抑制単語	斑点→班点（新）
りくつ	理屈	抑制単語	理窟→理屈（國）
りち	理知	抑制単語	理智→理知（國）
ようほう	用法	抑制単語	
かく	画	抑制単語	
かっきてき	画期的	抑制単語	劃期的→画期的（國）
かくぜん	画然	抑制単語	劃然→画然（國）
りゅういん	留飲	抑制単語	溜飲→留飲（新）
りゃくだつ	略奪	抑制単語	掠奪→略奪（國）
が	畫	抑制単語	
そめい	疎明	抑制単語	疏明→疎明（國）
そすい	疎水	抑制単語	疏水→疎水（國）
そつう	疎通	抑制単語	疏通→疎通（國）
びょうき	病気	抑制単語	
びょうぼつ	病沒	抑制単語	病歿→病沒（國）
はっこう	発酵	抑制単語	醗酵→発酵（國）
はつおん	発音	抑制単語	
もうどう	盲動	抑制単語	妄動→盲動（國）
もうあ	盲唖	抑制単語	
もうしゅう	盲執	抑制単語	妄執→盲執（新）
もうねん	盲念	抑制単語	妄念→盲念（新）
もうさう	盲想	抑制単語	妄想→盲想（新）
そうこく	相克	抑制単語	相剋→相克（國）
あいきゃく	相客	抑制単語	
そうとう	相当	抑制単語	
そうしそうあい	相思相愛	抑制単語	
あいしょう	相性	抑制単語	
そうあい	相愛	抑制単語	
あいて	相手	抑制単語	
あいかた	相方	抑制単語	
あいずち	相槌	抑制単語	
あいみたがい	相身互い	抑制単語	
あがた	県	抑制単語	
まっか	真っ赤	抑制単語	
しんせき	真跡	抑制単語	真蹟→真跡（國）
まっさお	真っ青	抑制単語	
ちのう	知能	抑制単語	智能→知能（國）
ちぼう	知謀	抑制単語	智謀→知謀（國）
たんへん	短編	抑制単語	短篇→短編（國）
たんぺん	短編	抑制単語	短篇→短編（國）
けんま	研摩	抑制単語	研磨→研摩（國）
はすい	破砕	抑制単語	破摧→破砕（國）
りゅうさん	硫酸	抑制単語	
かくじつ	確実	抑制単語	
きんこ	禁固	抑制単語	禁錮→禁固（新）
かがく	科学	抑制単語	
しょうさん	称賛	抑制単語	称(賞)讃→称(賞)賛（國）
たちあいにん	立会人	抑制単語	
たちあ	立ち会	抑制単語	
たちあ	立会	抑制単語	
たんざ	端座	抑制単語	端→端座（國）
ふちょう	符丁	抑制単語	符牒→符丁（國）
ふごう	符号	抑制単語	
ひっせき	筆跡	抑制単語	筆蹟→筆跡（國）
とうかち	等価値	抑制単語	
とうか	等価	抑制単語	
すじ	筋	抑制単語	
かんげん	管弦	抑制単語	
かんげんがく	管弦楽	抑制単語	管絃楽→管弦楽（國）
かんたん	簡単	抑制単語	
ふんそう	粉装	抑制単語	扮装→粉装（新）
きゅうだん	糾弾	抑制単語	糺弾→糾弾
ただ	糾	抑制単語	糺→糾（國）
きゅうめい	糾明	抑制単語	糺明→糾明（國）
じゅんぼく	純朴	抑制単語	醇朴→純朴（新）
しはん	紫班	抑制単語	紫斑→紫班（新）
しゅうそく	終息	抑制単語	終熄→終息（國）
けいゆ	経由	抑制単語	
けつごう	結合	抑制単語	
ぜっさん	絶賛	抑制単語	絶讃→絶賛（國）
けいしょう	継承	抑制単語	
けいぞく	継続	抑制単語	
めんか	綿花	抑制単語	棉花→綿花（國）
そうごう	総合	抑制単語	綜合→総合（國）
そうざい	総菜	抑制単語	惣菜→総菜（國）
せんけい	線形	抑制単語	
へんしゅう	編集	抑制単語	編輯→編集（國）
れんにゅう	練乳	抑制単語	煉乳→練乳（國）
れんま	練摩	抑制単語	練磨＊・錬磨→練摩（新）
れんたん	練炭	抑制単語	煉炭→練炭（國）
たてがき	縦書き	抑制単語	
たてがき	縦書	抑制単語	
しゅくしょう	縮小	抑制単語	
はんしょく	繁殖	抑制単語	蕃殖→繁殖（國）
ぎえんきん	義援金	抑制単語	義捐金→義援金（新）
こうこがく	考古学	抑制単語	
こうしょう	考証	抑制単語	
こううんき	耕運機	抑制単語	耕耘機→耕運機（新）
ちょうかく	聽覺	抑制単語	
ろうあ	聾唖	抑制単語	
かんじん	肝心	抑制単語	肝腎→肝心（國）
かんじんかなめ	肝心要	抑制単語	
はいとく	背徳	抑制単語	悖徳→背徳（國）
ごまあえ	胡麻和え	抑制単語	
みゃくはく	脈拍	抑制単語	脈愽→脈拍（新）
ふらん	腐乱	抑制単語	腐爛→腐乱（國）
ふしょく	腐食	抑制単語	腐蝕→腐食（國）
したびらめ	舌平目	抑制単語	
ほそう	舗装	抑制単語	鋪装→舗装（國）
せんそう	船倉	抑制単語	船艙→船倉（國）
しきよく	色欲	抑制単語	色慾→色欲（國）
ほうじゅん	芳純	抑制単語	芳醇→芳純（新）
くとう	苦闘	抑制単語	
わらじ	草鞋	抑制単語	
らくご	落後	抑制単語	落伍→落後（新）
らくばん	落盤	抑制単語	落磐→落盤（國）
じょうりゅう	蒸留	抑制単語	蒸溜→蒸留（國）
じょうりゅうすい	蒸留水	抑制単語	
あおなみ	蒼波	抑制単語	
はくこう	薄幸	抑制単語	薄倖→薄幸（國）
くんじょう	薫蒸	抑制単語	燻蒸→薫蒸（新）
くんせい	薫製	抑制単語	燻製→薫製（國）
くすり	薬	抑制単語	
ふじ	藤	抑制単語	
ふじなみ	藤波	抑制単語	
ふじなみ	藤浪	抑制単語	
あせい	蛙声	抑制単語	
かえる	蛙	抑制単語	
ばんぞく	蛮族	抑制単語	蕃族→蛮族（國）
ぎょう	行	抑制単語	
ひょうい	表意	抑制単語	
ひょうげん	表現	抑制単語	
ひょうき	表記	抑制単語	
すいたい	衰退	抑制単語	衰頽→衰退（國）
そうてい	装丁	抑制単語	装釘(幀)→装丁（國）
ほさ	補佐	抑制単語	輔佐→補佐（國）
ほどう	補導	抑制単語	輔導→補導（國）
ふくしゃ	複写	抑制単語	
ふくすう	複数	抑制単語	
おぼえ	覚え	抑制単語	
かいしゃく	解釈	抑制単語	
くんかい	訓戒	抑制単語	訓誡→訓戒（國）
わけ	訳	抑制単語	
ちゅうしゃく	註釈	抑制単語	
あかしびと	証人	抑制単語	
しょうにん	証人	抑制単語	
あかしぶみ	証文	抑制単語	
ひょうか	評価	抑制単語	
しあい	試合	抑制単語	
しれん	試練	抑制単語	試煉→試練（國）
あつらえ	誂え	抑制単語	
あつらえ	誂	抑制単語	
ごどう	誤導	抑制単語	
どくしょ	読書	抑制単語	
どくしゃ	読者	抑制単語	
ちょうさ	調査	抑制単語	
こうわ	講和	抑制単語	媾和→講和（國）
わけ	譯	抑制単語	
ほうふ	豊富	抑制単語	
ぞうがん	象眼	抑制単語	象嵌→象眼（國）
ふたん	負担	抑制単語	
かんろく	貫禄	抑制単語	貫禄→貫録（新）
かんろく	貫録	抑制単語	貫禄→貫録（新）
さんぎょう	賛仰	抑制単語	讃仰→賛仰（國）
さんたん	賛嘆	抑制単語	讃嘆→賛嘆（國）
さんび	賛美	抑制単語	讃美→賛美（國）
さんじ	賛辞	抑制単語	讃辞→賛辞（國）
しちぐさ	質草	抑制単語	質種→質草（新）
あかしんごう	赤信号	抑制単語	
あかはじ	赤恥	抑制単語	
ふ	踏	抑制単語	蹈→踏（國）
とうしゅう	踏襲	抑制単語	蹈襲→踏襲（國）
しゃりょう	車両	抑制単語	車輌→車両（國）
てんとう	転倒	抑制単語	顛倒→転倒（國）
てんぷく	転覆	抑制単語	顛覆→転覆（國）
りんかく	輪郭	抑制単語	輪廓→輪郭（國）
へんきょう	辺境	抑制単語	辺疆→辺境（國）
たいせい	退勢	抑制単語	頽勢→退勢（國）
たいはい	退廃	抑制単語	頽廃→退廃（國）
たいしょく	退色	抑制単語	褪色→退色（國）
とぜつ	途絶	抑制単語	杜絶→途絶（國）
あいびき	逢引	抑制単語	
おうせ	逢瀬	抑制単語	
れんたいけい	連体形	抑制単語	
れんけい	連係	抑制単語	連繋→連係（國）
れんごう	連合	抑制単語	聯合→連合（國）
れんざ	連座	抑制単語	連坐→連座（國）
れんさう	連想	抑制単語	聯想→連想（國）
れんじゅ	連珠	抑制単語	聯珠→連珠（國）
れんめい	連盟	抑制単語	聯盟→連盟（國）
れんりつ	連立	抑制単語	聯立→連立（國）
れんらく	連絡	抑制単語	聯絡→連絡（國）
れんぽう	連邦	抑制単語	聯邦→連邦（國）
てきごう	適合	抑制単語	
せんこう	選考	抑制単語	
さくさん	酢酸	抑制単語	醋酸→酢酸（國）
しゅうあく	醜悪	抑制単語	
しゃく	釈	抑制単語	
りよう	里謡	抑制単語	俚謡→里謡（國）
やひ	野卑	抑制単語	野鄙→野卑（國）
しんじゅつ	針術	抑制単語	鍼術→針術（國）
こうぎょう	鉱業	抑制単語	礦業→鉱業（國）
こうせき	鉱石	抑制単語	礦石→鉱石（國）
さっかく	錯覚	抑制単語	
ちょうへん	長編	抑制単語	長篇→長編（國）
あいうち	間打ち	抑制単語	
あいふく	間服	抑制単語	
かんけつ	間欠	抑制単語	間歇→間欠（國）
あいきょうげん	間狂言	抑制単語	
あいぎ	間着	抑制単語	
かんしょく	間食	抑制単語	
かんけい	関係	抑制単語	
かんしん	関心	抑制単語	
かんすう	関数	抑制単語	
くわんすう	關數	抑制単語	
ぼうあつ	防圧	抑制単語	防遏→防圧（新）
ぼうぎょ	防御	抑制単語	防禦→防御（國）
そそう	阻喪	抑制単語	沮喪→阻喪（國）
そし	阻止	抑制単語	沮止→阻止（國）
あしゅら	阿修羅	抑制単語	
あみだ	阿弥陀	抑制単語	
あびきょうかん	阿鼻叫喚	抑制単語	
けんそ	険阻	抑制単語	嶮岨→険阻（國）
しょうへき	障壁	抑制単語	
しょうがい	障害	抑制単語	障碍→障害（國）
しょうがいしゃ	障害者	抑制単語	
しゅうちゅう	集中	抑制単語	
しゅうごう	集合	抑制単語	
しゅうか	集荷	抑制単語	蒐荷→集荷（國）
しふか	集荷	抑制単語	蒐荷→集荷（國）
しゅうらく	集落	抑制単語	聚落→集落（國）
こよう	雇用	抑制単語	雇傭→雇用（國）
ざっとう	雑踏	抑制単語	雑沓→雑踏（國）
りはん	離反	抑制単語	離叛→離反（國）
ふんいき	雰囲気	抑制単語	
あおにさい	青二才	抑制単語	
あおしんごう	青信号	抑制単語	
あおじゃし	青写真	抑制単語	
あおみ	青味	抑制単語	
あおいきといき	青息吐息	抑制単語	
あおいき	青息	抑制単語	
あお	青	抑制単語	
あおもの	青物	抑制単語	
あおすじ	青筋	抑制単語	
あおな	青菜	抑制単語	
じゅんとう	順当	抑制単語	
あずか	預か	抑制単語	
あずけ	預け	抑制単語	
ずつう	頭痛	抑制単語	
ふうこうめいび	風光明美	抑制単語	風光明媚→風光明美（新）
ふうし	風刺	抑制単語	諷刺→風刺（國）
ひご	飛語	抑制単語	蜚語→飛語（國）
しょくじ	食事	抑制単語	
しょくじりょうほう	食事療法	抑制単語	食餌療法→食事療法（新）
しょくひん	食品	抑制単語	
しょくじん	食尽	抑制単語	蝕甚→食尽（國）
しょくざい	食材	抑制単語	
しょくよく	食欲	抑制単語	食慾→食欲（國）
こうでん	香典	抑制単語	香奠→香典（國）
こっかく	骨格	抑制単語	骨骼→骨格（國）
こうよう	高揚	抑制単語	昂揚→高揚（國）
こうしん	高進	抑制単語	昂進・亢進→高進（新）
こうとう	高騰	抑制単語	昂騰→高騰（國）
ぎょろう	魚労	抑制単語	魚撈→魚労（國）
ちょうかんず	鳥観図	抑制単語	鳥瞰図→鳥観図（新）
ちょうかん	鳥観	抑制単語	
はかい	破壊	抑制単語	
こうてい	校訂	抑制単語	
しょぎょうむじょう	諸行無常	抑制単語	
たんじゅん	単純	抑制単語	
よてい	予定	抑制単語	
よ	酔	抑制単語	
さんごくし	三国志	抑制単語	
こうぞう	構造	抑制単語	
はっせい	発声	抑制単語	
きょう	今日	抑制単語	
ちゅうごく	中国	抑制単語	差別用語
ちゅうごくじん	中国人	抑制単語	差別用語
うつわ	器	抑制単語	
はまき	葉巻	抑制単語	
しょう	咲	抑制単語	
しょう	笑	抑制単語	
げんき	元気	抑制単語	
びょうき	病期	抑制単語	
きしつ	気質	抑制単語	
びょうぎ	廟議	抑制単語	
たんご	単語	抑制単語	
